a	ഒന്ന്
abandon	ഉപേക്ഷിക്കുക
ability	കഴിവ്
able	കഴിവുള്ള
abortion	ഗർഭച്ഛിദ്രം
about	കുറിച്ച്
above	മുകളിൽ
abroad	വിദേശത്ത്
absence	അഭാവം
absolute	കേവല
absolutely	തികച്ചും
absorb	ആഗിരണം
abuse	ദുരുപയോഗം
academic	അക്കാദമിക്
accept	സ്വീകരിക്കുക
access	പ്രവേശനം
accident	അപകടം
accompany	കൂടെപ്പോവുക
accomplish	നിറവേറ്റുക
according	പ്രകാരം
account	അക്കൗണ്ട്
accurate	കൃത്യം
accuse	ബോധിപ്പിക്കുന്ന
achieve	നേടിയെടുക്കാൻ
achievement	നേട്ടം
acid	ആസിഡ്
acknowledge	അംഗീകരിക്കുന്നു
acquire	സ്വന്തമാക്കുക
across	ഉടനീളം
act	പ്രവർത്തിക്കുക
action	നടപടി
active	സജീവമാണ്
activist	പ്രവർത്തകൻ
activity	പ്രവർത്തനം
actor	നടൻ
actress	നടി
actual	യഥാർത്ഥ
actually	യഥാർത്ഥത്തിൽ
ad	പരസ്യം
adapt	പൊരുത്തപ്പെടുത്തുക
add	ചേർക്കുക
addition	കൂട്ടിച്ചേർക്കൽ
additional	അധിക
address	വിലാസം
adequate	മതി
adjust	ക്രമീകരിക്കുക
adjustment	ക്രമീകരണം
administration	ഭരണകൂടം
administrator	അഡ്മിനിസ്ട്രേറ്റർ
admire	അഭിനന്ദിക്കുക
admission	പ്രവേശനം
admit	സമ്മതിക്കുക
adolescent	കൗമാരക്കാരൻ
adopt	ദത്തെടുക്കുക
adult	മുതിർന്നവർ
advance	മുൻകൂർ
advanced	പുരോഗമിച്ചത്
advantage	നേട്ടം
adventure	സാഹസികത
advertising	പരസ്യം ചെയ്യൽ
advice	ഉപദേശം
advise	ഉപദേശിക്കുക
adviser	ഉപദേശകൻ
advocate	അഭിഭാഷകൻ
affair	ബന്ധം
affect	ബാധിക്കും
afford	താങ്ങുക
afraid	ഭയപ്പെട്ടു
African	ആഫ്രിക്കൻ
African-American	ആഫ്രിക്കൻ അമേരിക്കൻ
after	ശേഷം
afternoon	ഉച്ചകഴിഞ്ഞ്
again	വീണ്ടും
against	എതിരായി
age	പ്രായം
agency	ഏജൻസി
agenda	അജണ്ട
agent	ഏജന്റ്
aggressive	ആക്രമണാത്മക
ago	മുമ്പ്
agree	സമ്മതിക്കുന്നു
agreement	ഉടമ്പടി
agricultural	കാർഷിക
ahead	മുന്നോട്ട്
aid	സഹായം
aide	സഹായി
AIDS	എയ്ഡ്സ്
aim	ലക്ഷ്യം
air	വായു
aircraft	വിമാനം
airline	എയർലൈൻ
airport	വിമാനത്താവളം
album	ആൽബം
alcohol	മദ്യം
alive	ജീവനോടെ
all	എല്ലാം
alliance	സഖ്യം
allow	അനുവദിക്കുക
ally	സഖ്യകക്ഷി
almost	ഏതാണ്ട്
alone	ഒറ്റയ്ക്ക്
along	കൂടെ
already	ഇതിനകം
also	കൂടാതെ
alter	മാറ്റുക
alternative	ബദൽ
although	എങ്കിലും
always	എപ്പോഴും
am	ഞാൻ
amazing	അത്ഭുതകരമായ
American	അമേരിക്കൻ
among	കൂട്ടത്തിൽ
amount	തുക
an	ഒരു
analysis	വിശകലനം
analyst	അനലിസ്റ്റ്
analyze	വിശകലനം ചെയ്യുക
ancient	പുരാതനമായ
and	ഒപ്പം
anger	കോപം
angle	കോൺ
angry	ദേഷ്യം
animal	മൃഗം
anniversary	വാർഷികം
announce	പ്രഖ്യാപിക്കുന്നു
annual	വാർഷിക
another	മറ്റൊന്ന്
answer	ഉത്തരം
anticipate	പ്രതീക്ഷിക്കുക
anxiety	ഉത്കണ്ഠ
any	ഏതെങ്കിലും
anybody	ആരെങ്കിലും
anymore	ഇനി
anyone	ആർക്കും
anything	എന്തും
anyway	എന്തായാലും
anywhere	എവിടെയും
apart	വേറിട്ട്
apartment	അപ്പാർട്ട്മെന്റ്
apparent	പ്രത്യക്ഷമായി
apparently	പ്രത്യക്ഷമായും
appeal	അപ്പീൽ
appear	പ്രത്യക്ഷപ്പെടുന്നു
appearance	രൂപം
apple	ആപ്പിൾ
application	അപേക്ഷ
apply	പ്രയോഗിക്കുക
appoint	നിയമിക്കുക
appointment	നിയമനം
appreciate	അഭിനന്ദിക്കുന്നു
approach	സമീപനം
appropriate	ഉചിതമായ
approval	അംഗീകാരം
approve	അംഗീകരിക്കുന്നു
approximately	ഏകദേശം
Arab	അറബ്
architect	വാസ്തുശില്പി
are	ആകുന്നു
area	പ്രദേശം
argue	വാദിക്കുക
argument	വാദം
arise	ഉദിക്കുന്നു
arm	കൈക്ക്
armed	ആയുധധാരികൾ
army	സൈന്യം
around	ചുറ്റും
arrange	ക്രമീകരിക്കുക
arrangement	ക്രമീകരണം
arrest	അറസ്റ്റ്
arrival	വരവ്
arrive	എത്തുക
art	കല
article	ലേഖനം
artist	കലാകാരൻ
artistic	കലാപരമായ
as	ആയി
Asian	ഏഷ്യൻ
aside	മാറ്റിവച്ചു
ask	ചോദിക്കുക
asleep	ഉറങ്ങുകയാണ്
aspect	വശം
assault	കയ്യേറ്റം നടത്തുക
assert	ഉറപ്പിക്കുക
assess	വിലയിരുത്തുക
assessment	വിലയിരുത്തൽ
asset	ആസ്തി
assign	നിയോഗിക്കുക
assignment	നിയമനം
assist	സഹായിക്കുക
assistance	സഹായം
assistant	സഹായി
associate	അസോസിയേറ്റ്
association	അസോസിയേഷൻ
assume	അനുമാനിക്കുക
assumption	അനുമാനം
assure	ഉറപ്പുതരുന്നു
athlete	അത്ലറ്റ്
athletic	അത്ലറ്റിക്
atmosphere	അന്തരീക്ഷം
atom	ആറ്റം
attach	അറ്റാച്ചുചെയ്യുക
attack	ആക്രമണം
attempt	ശ്രമം
attend	പങ്കെടുക്കുക
attention	ശ്രദ്ധ
attitude	മനോഭാവം
attorney	അഭിഭാഷകൻ
attract	ആകർഷിക്കുക
attractive	ആകർഷകമായ
attribute	ആട്രിബ്യൂട്ട്
audience	പ്രേക്ഷകർ
author	രചയിതാവ്
authority	അധികാരം
auto	ഓട്ടോ
available	ലഭ്യമാണ്
average	ശരാശരി
avoid	ഒഴിവാക്കുക
award	അവാർഡ്
aware	അറിഞ്ഞിരിക്കുക
awareness	അവബോധം
away	ദൂരെ
awful	ഭയങ്കരം
baby	കുഞ്ഞ്
back	തിരികെ
background	പശ്ചാത്തലം
bad	മോശം
badly	മോശമായി
bag	ബാഗ്
bake	ചുടേണം
balance	ബാലൻസ്
ball	പന്ത്
ban	നിരോധനം
band	ബാൻഡ്
bank	ബാങ്ക്
bar	ബാർ
barely	കഷ്ടിച്ച്
barrel	വീപ്പ
barrier	തടസ്സം
base	അടിസ്ഥാനം
baseball	ബേസ്ബോൾ
basic	അടിസ്ഥാന
basically	അടിസ്ഥാനപരമായി
basis	അടിസ്ഥാനം
basket	കൊട്ടയിൽ
basketball	ബാസ്കറ്റ്ബോൾ
bat	ബാറ്റ്
bathroom	കുളിമുറി
battery	ബാറ്ററി
battle	യുദ്ധം
be	ആയിരിക്കും
beach	ബീച്ച്
bean	ബീൻ
bear	കരടി
beat	അടിച്ചു
beautiful	മനോഹരമായ
beauty	സൗന്ദര്യം
because	കാരണം
become	ആയിത്തീരുന്നു
bed	കിടക്ക
bedroom	കിടപ്പുമുറി
been	ആകുമായിരുന്നു
beer	ബിയർ
before	മുമ്പ്
began	തുടങ്ങി
begin	ആരംഭിക്കുന്നു
beginning	തുടക്കം
behavior	പെരുമാറ്റം
behind	പിന്നിൽ
being	ആണ്
belief	വിശ്വാസം
believe	വിശ്വസിക്കുക
bell	മണി
belong	ഉൾപ്പെടുന്നു
below	താഴെ
belt	ബെൽറ്റ്
bench	ബെഞ്ച്
bend	വളയ്ക്കുക
beneath	കീഴ്ഭാഗത്ത്
benefit	പ്രയോജനം
beside	അരികിൽ
besides	കൂടാതെ
best	മികച്ച
bet	പന്തയം
better	മെച്ചപ്പെട്ട
between	തമ്മിലുള്ള
beyond	അപ്പുറം
Bible	ബൈബിൾ
big	വലിയ
bike	ബൈക്ക്
bill	ബിൽ
billion	ബില്യൺ
bind	കെട്ടുക
biological	ജീവശാസ്ത്രപരമായ
bird	പക്ഷി
birth	ജനനം
birthday	ജന്മദിനം
bit	ബിറ്റ്
bite	കടിക്കുക
black	കറുപ്പ്
blade	ബ്ലേഡ്
blame	കുറ്റപ്പെടുത്തുക
blanket	പുതപ്പ്
blind	അന്ധൻ
block	തടയുക
blood	രക്തം
blow	തുക
blue	നീല
board	ബോർഡ്
boat	ബോട്ട്
body	ശരീരം
bomb	ബോംബ്
bombing	ബോംബിംഗ്
bond	ബോണ്ട്
bone	അസ്ഥി
book	പുസ്തകം
boom	ബൂം
boot	ബൂട്ട്
border	അതിർത്തി
born	ജനിച്ചു
borrow	കടം വാങ്ങുക
boss	മുതലാളി
both	രണ്ടും
bother	ശല്യപ്പെടുത്തുക
bottle	കുപ്പി
bottom	താഴെ
bought	വാങ്ങി
boundary	അതിർത്തി
bowl	പാത്രം
box	പെട്ടി
boy	ആൺകുട്ടി
boyfriend	കാമുകൻ
brain	തലച്ചോറ്
branch	ശാഖ
brand	ബ്രാൻഡ്
bread	അപ്പം
break	ഇടവേള
breakfast	പ്രഭാതഭക്ഷണം
breast	മുല
breath	ശ്വാസം
breathe	ശ്വസിക്കുക
brick	ഇഷ്ടിക
bridge	പാലം
brief	ചുരുക്കത്തിലുള്ള
briefly	ചുരുക്കത്തിൽ
bright	ശോഭയുള്ള
brilliant	മിടുക്കൻ
bring	കൊണ്ടുവരിക
British	ബ്രിട്ടീഷ്
broad	വിശാലമായ
broke	തകർത്തു
broken	തകർത്തു
brother	സഹോദരൻ
brought	കൊണ്ടുവന്നു
brown	തവിട്ട്
brush	ബ്രഷ്
buck	ബക്ക്
budget	ബജറ്റ്
build	പണിയുക
building	കെട്ടിടം
bullet	ബുള്ളറ്റ്
bunch	കൂട്ടം
burden	ഭാരം
burn	കത്തിക്കുക
bury	അടക്കം ചെയ്യുക
bus	ബസ്
business	ബിസിനസ്സ്
busy	തിരക്ക്
but	പക്ഷേ
butter	വെണ്ണ
button	ബട്ടൺ
buy	വാങ്ങാൻ
buyer	വാങ്ങുന്നയാൾ
by	വഴി
cabin	ചെറിയമുറി
cabinet	കാബിനറ്റ്
cable	കേബിൾ
cake	കേക്ക്
calculate	കണക്കുകൂട്ടുക
call	വിളി
came	വന്നു
camera	ക്യാമറ
camp	ക്യാമ്പ്
campaign	പ്രചാരണം
campus	കാമ്പസ്
can	കഴിയും
Canadian	കനേഡിയൻ
cancer	അർബുദം
candidate	സ്ഥാനാർത്ഥി
cap	തൊപ്പി
capability	കഴിവ്
capable	കഴിവുള്ള
capacity	ശേഷി
capital	മൂലധനം
captain	ക്യാപ്റ്റൻ
capture	പിടിച്ചെടുക്കൽ
car	കാർ
carbon	കാർബൺ
card	കാർഡ്
care	കെയർ
career	കരിയർ
careful	ശ്രദ്ധയോടെ
carefully	ശ്രദ്ധാപൂർവ്വം
carrier	കാരിയർ
carry	ചുമക്കുക
case	കേസ്
cash	പണം
cast	കാസ്റ്റ്
cat	പൂച്ച
catch	പിടിക്കുക
category	വിഭാഗം
Catholic	കത്തോലിക്കൻ
caught	പിടിക്കപെട്ടു
cause	കാരണം
ceiling	സീലിംഗ്
celebrate	ആഘോഷിക്കാൻ
celebration	ആഘോഷം
celebrity	സെലിബ്രിറ്റി
cell	സെൽ
cent	സെന്റ്
center	കേന്ദ്രം
central	കേന്ദ്ര
century	നൂറ്റാണ്ട്
CEO	സിഇഒ
ceremony	ചടങ്ങ്
certain	നിശ്ചയം
certainly	തീർച്ചയായും
chain	ചങ്ങല
chair	കസേര
chairman	ചെയർമാൻ
challenge	വെല്ലുവിളി
chamber	ചേംബർ
champion	ചാമ്പ്യൻ
championship	ചാമ്പ്യൻഷിപ്പ്
chance	അവസരം
change	മാറ്റം
changing	മാറ്റുന്നതിൽ
channel	ചാനൽ
chapter	അദ്ധ്യായം
character	സ്വഭാവം
characteristic	സ്വഭാവം
characterize	സ്വഭാവം
charge	ചാർജ്
charity	ചാരിറ്റി
chart	ചാർട്ട്
chase	പിന്തുടരുക
cheap	വിലകുറഞ്ഞ
check	ചെക്ക്
cheek	കവിൾ
cheese	ചീസ്
chef	പാചകക്കാരൻ
chemical	രാസവസ്തു
chest	നെഞ്ച്
chick	കോഴിക്കുഞ്ഞ്
chicken	കോഴി
chief	ചീഫ്
child	കുട്ടി
childhood	കുട്ടിക്കാലം
children	കുട്ടികൾ
Chinese	ചൈനീസ്
chip	ചിപ്പ്
chocolate	ചോക്ലേറ്റ്
choice	ചോയ്സ്
cholesterol	കൊളസ്ട്രോൾ
choose	തിരഞ്ഞെടുക്കുക
chord	കോർഡ്
Christian	ക്രിസ്ത്യൻ
Christmas	ക്രിസ്മസ്
church	ക്രിസ്ത്യൻ പള്ളി
cigarette	സിഗരറ്റ്
circle	വൃത്തം
circumstance	സാഹചര്യം
cite	ഉദ്ധരിക്കുക
citizen	പൗരൻ
city	നഗരം
civil	സിവിൽ
civilian	സിവിലിയൻ
claim	അവകാശം
class	ക്ലാസ്
classic	ക്ലാസിക്
classroom	ക്ലാസ് മുറി
clean	ശുദ്ധിയുള്ള
clear	തെളിഞ്ഞ
clearly	വ്യക്തമായി
client	കക്ഷി
climate	കാലാവസ്ഥ
climb	കയറുക
clinic	ക്ലിനിക്
clinical	ക്ലിനിക്കൽ
clock	ക്ലോക്ക്
close	അടയ്ക്കുക
closely	അടുത്ത്
closer	അടുത്തു
clothe	വസ്ത്രം
clothes	വസ്ത്രങ്ങൾ
clothing	ഉടുപ്പു
cloud	മേഘം
club	ക്ലബ്
clue	സൂചന
cluster	ക്ലസ്റ്റർ
coach	പരിശീലകൻ
coal	കൽക്കരി
coalition	കൂട്ടുകക്ഷി
coast	തീരം
coat	അങ്കി
code	കോഡ്
coffee	കോഫി
cognitive	വൈജ്ഞാനികം
cold	തണുപ്പ്
collapse	തകർച്ച
colleague	സഹപ്രവർത്തകൻ
collect	ശേഖരിക്കുക
collection	സമാഹാരം
collective	കൂട്ടായ
college	കോളേജ്
colonial	കൊളോണിയൽ
colony	കോളനി
color	നിറം
column	കോളം
combination	കോമ്പിനേഷൻ
combine	സംയോജിപ്പിക്കുക
come	വരൂ
comedy	കോമഡി
comfort	ആശ്വാസം
comfortable	സുഖപ്രദമായ
command	കമാൻഡ്
commander	കമാൻഡർ
comment	അഭിപ്രായം
commercial	വാണിജ്യ
commission	കമ്മീഷൻ
commit	പ്രതിബദ്ധത
commitment	പ്രതിബദ്ധത
committee	കമ്മിറ്റി
common	സാധാരണ
communicate	ആശയവിനിമയം നടത്തുക
communication	ആശയവിനിമയം
community	സമൂഹം
company	കമ്പനി
compare	താരതമ്യം ചെയ്യുക
comparison	താരതമ്യം
compete	മത്സരിക്കുക
competition	മത്സരം
competitive	മത്സരാധിഷ്ഠിത
competitor	എതിരാളി
complain	പരാതിപ്പെടുക
complaint	പരാതി
complete	പൂർത്തിയായി
completely	പൂർണ്ണമായും
complex	സങ്കീർണ്ണമായ
complicated	സങ്കീർണ്ണമായ
component	ഘടകം
compose	രചിക്കുക
composition	രചന
comprehensive	സമഗ്രമായ
computer	കമ്പ്യൂട്ടർ
concentrate	ഏകോപിപ്പിക്കുക
concentration	ഏകാഗ്രത
concept	ആശയം
concern	ആശങ്ക
concerned	ബന്ധപ്പെട്ട
concert	കച്ചേരി
conclude	നിഗമനം
conclusion	ഉപസംഹാരം
concrete	കോൺക്രീറ്റ്
condition	അവസ്ഥ
conduct	നടത്തുക
conference	സമ്മേളനം
confidence	ആത്മവിശ്വാസം
confident	ആത്മവിശ്വാസം
confirm	സ്ഥിരീകരിക്കുക
conflict	സംഘർഷം
confront	അഭിമുഖീകരിക്കുക
confusion	ആശയക്കുഴപ്പം
Congress	കോൺഗ്രസ്
congressional	കോൺഗ്രസ്
connect	ബന്ധിപ്പിക്കുക
connection	കണക്ഷൻ
consciousness	ബോധം
consensus	സമവായം
consequence	അനന്തരഫലം
conservative	യാഥാസ്ഥിതിക
consider	പരിഗണിക്കുക
considerable	ഗണ്യമായ
consideration	പരിഗണന
consist	ഉൾക്കൊള്ളുന്നു
consistent	സ്ഥിരതയുള്ള
consonant	വ്യഞ്ജനം
constant	സ്ഥിരമായ
constantly	നിരന്തരം
constitute	രൂപീകരിക്കുക
constitutional	ഭരണഘടനാപരമായ
construct	നിർമ്മിക്കുക
construction	നിർമാണം
consultant	കൺസൾട്ടന്റ്
consume	ഉപഭോഗം ചെയ്യുക
consumer	ഉപഭോക്താവ്
consumption	ഉപഭോഗം
contact	ബന്ധപ്പെടുക
contain	അടങ്ങിയിട്ടുണ്ട്
container	കണ്ടെയ്നർ
contemporary	സമകാലിക
content	ഉള്ളടക്കം
contest	മത്സരം
context	സന്ദർഭം
continent	ഭൂഖണ്ഡം
continue	തുടരുക
continued	തുടർന്ന
contract	കരാർ
contrast	ദൃശ്യതീവ്രത
contribute	സംഭാവന ചെയ്യുക
contribution	സംഭാവന
control	നിയന്ത്രണം
controversial	വിവാദമായി
controversy	വിവാദം
convention	കൺവെൻഷൻ
conventional	പരമ്പരാഗത
conversation	സംഭാഷണം
convert	മാറ്റുക
conviction	ബോധ്യം
convince	ബോധ്യപ്പെടുത്തുന്നു
cook	പാചകം
cookie	കുക്കി
cooking	പാചകം
cool	അടിപൊളി
cooperation	സഹകരണം
cop	പോലീസ്
cope	നേരിടാൻ
copy	കോപ്പി
core	കാമ്പ്
corn	ചോളം
corner	മൂല
corporate	കോർപ്പറേറ്റ്
corporation	കോർപ്പറേഷൻ
correct	ശരിയാണ്
correspondent	ലേഖകൻ
cost	ചെലവ്
cotton	പരുത്തി
couch	സോഫ
could	കഴിയുമായിരുന്നു
council	കൗൺസിൽ
counselor	ഉപദേഷ്ടാവ്
count	എണ്ണുക
counter	കൗണ്ടർ
country	രാജ്യം
county	കൗണ്ടി
couple	ദമ്പതികൾ
courage	ധൈര്യം
course	കോഴ്സ്
court	കോടതി
cousin	കസിൻ
cover	കവർ
coverage	കവറേജ്
cow	പശു
crack	പിളര്പ്പ്
craft	കരകൗശല
crash	തകര്ച്ച
crazy	ഭ്രാന്തൻ
cream	ക്രീം
crease	ക്രീസ്
create	സൃഷ്ടിക്കാൻ
creation	സൃഷ്ടി
creative	സൃഷ്ടിപരമായ
creature	ജീവി
credit	ക്രെഡിറ്റ്
crew	ജീവനക്കാർ
crime	കുറ്റകൃത്യം
criminal	ക്രിമിനൽ
crisis	പ്രതിസന്ധി
criteria	മാനദണ്ഡം
critic	വിമർശകൻ
critical	നിർണായകമാണ്
criticism	വിമർശനം
criticize	വിമർശിക്കുന്നു
crop	വിള
cross	കുരിശ്
crowd	ആൾക്കൂട്ടം
crucial	നിർണായകമായ
cry	കരയുക
cultural	സാംസ്കാരിക
culture	സംസ്കാരം
cup	കപ്പ്
curious	കൗതുകകരമായ
current	കറന്റ്
currently	നിലവിൽ
curriculum	പാഠ്യപദ്ധതി
custom	കസ്റ്റം
customer	ഉപഭോക്താവ്
cut	മുറിച്ചു
cycle	ചക്രം
dad	അച്ഛൻ
daily	ദിവസേന
damage	കേടുപാടുകൾ
dance	നൃത്തം
danger	അപായം
dangerous	അപകടകരമായ
dare	ധൈര്യം
dark	ഇരുട്ട്
darkness	ഇരുട്ട്
data	ഡാറ്റ
date	തീയതി
daughter	മകൾ
day	ദിവസം
dead	മരിച്ചു
deal	ഇടപാട്
dealer	ഡീലർ
dear	പ്രിയ
death	മരണം
debate	സംവാദം
debt	കടം
decade	ദശാബ്ദം
decide	തീരുമാനിക്കുക
decimal	ദശാംശം
decision	തീരുമാനം
deck	ഡെക്ക്
declare	പ്രഖ്യാപിക്കുക
decline	ഇടിവ്
decrease	കുറയുന്നു
deep	ആഴത്തിൽ
deeply	ആഴത്തിൽ
deer	മാനുകൾ
defeat	പരാജയം
defend	പ്രതിരോധിക്കുക
defendant	എതൃകക്ഷി
defense	പ്രതിരോധം
defensive	പ്രതിരോധം
deficit	കമ്മി
define	നിർവ്വചിക്കുക
definitely	തീർച്ചയായും
definition	നിർവ്വചനം
degree	ഡിഗ്രി
delay	കാലതാമസം
deliver	എത്തിക്കുക
delivery	ഡെലിവറി
demand	ആവശ്യം
democracy	ജനാധിപത്യം
Democrat	ഡെമോക്രാറ്റ്
democratic	ജനാധിപത്യപരമായ
demonstrate	പ്രകടിപ്പിക്കുക
demonstration	പ്രകടനം
deny	നിഷേധിക്കുക
department	വകുപ്പ്
depend	ആശ്രയിക്കുന്നത്
dependent	ആശ്രിത
depending	ആശ്രയിക്കുന്നത്
depict	ചിത്രീകരിക്കുക
depression	വിഷാദം
depth	ആഴം
deputy	ഡെപ്യൂട്ടി
derive	ഉത്ഭവിക്കുക
describe	വിവരിക്കുക
description	വിവരണം
desert	ഏകാന്ത
deserve	അർഹിക്കുന്നു
design	ഡിസൈൻ
designer	ഡിസൈനർ
desire	ആഗ്രഹം
desk	ഡെസ്ക്ക്
desperate	നിരാശ
despite	ഉണ്ടായിരുന്നിട്ടും
destroy	നശിപ്പിക്കുക
destruction	നാശം
detail	വിശദമായി
detailed	വിശദമായ
detect	കണ്ടുപിടിക്കുക
determine	നിർണ്ണയിക്കുക
develop	വികസിപ്പിക്കുക
developing	വികസിക്കുന്നു
development	വികസനം
device	ഉപകരണം
devote	സമർപ്പിക്കുക
dialogue	ഡയലോഗ്
dictionary	നിഘണ്ടു
did	ചെയ്തു
die	മരിക്കുക
diet	ഭക്ഷണക്രമം
differ	വ്യത്യാസമുണ്ട്
difference	വ്യത്യാസം
different	വ്യത്യസ്ത
differently	വ്യത്യസ്തമായി
difficult	ബുദ്ധിമുട്ടുള്ള
difficulty	ബുദ്ധിമുട്ട്
dig	കുഴിക്കുക
digital	ഡിജിറ്റൽ
dimension	അളവ്
dining	ഡൈനിംഗ്
dinner	അത്താഴം
direct	നേരിട്ട്
direction	സംവിധാനം
directly	നേരിട്ട്
director	സംവിധായകൻ
dirt	അഴുക്ക്
dirty	അഴുക്കായ
disability	വികലത
disagree	വിയോജിക്കുന്നു
disappear	അപ്രത്യക്ഷമാകുന്നു
disaster	ദുരന്തം
discipline	അച്ചടക്കം
discourse	പ്രഭാഷണം
discover	കണ്ടെത്തുക
discovery	കണ്ടെത്തൽ
discrimination	വിവേചനം
discuss	ചർച്ച ചെയ്യുക
discussion	ചർച്ച
disease	രോഗം
dish	വിഭവം
dismiss	പിരിച്ചുവിടുക
disorder	ക്രമക്കേട്
display	പ്രദർശിപ്പിക്കുക
dispute	തർക്കം
distance	ദൂരം
distant	അകലെ
distinct	വ്യത്യസ്തരായ
distinction	വ്യത്യാസം
distinguish	വേർതിരിച്ചറിയുക
distribute	വിതരണം ചെയ്യുക
distribution	വിതരണ
district	ജില്ല
diverse	വൈവിധ്യമാർന്ന
diversity	വൈവിധ്യം
divide	വീതിക്കുക
division	ഡിവിഷൻ
divorce	വിവാഹമോചനം
DNA	ഡി.എൻ.എ
do	ചെയ്യുക
doctor	ഡോക്ടർ
document	പ്രമാണം
does	ചെയ്യുന്നു
dog	നായ
dollar	ഡോളർ
domestic	ആഭ്യന്തര
dominant	പ്രബലമായ
dominate	ആധിപത്യം സ്ഥാപിക്കുക
don’t	ചെയ്യരുത്
done	ചെയ്തു
door	വാതിൽ
double	ഇരട്ട
doubt	സംശയം
down	താഴേക്ക്
downtown	ഡൗൺടൗൺ
dozen	ഡസൻ
draft	കരട്
drag	വലിച്ചിടുക
drama	നാടകം
dramatic	നാടകീയമായ
dramatically	നാടകീയമായി
draw	വരയ്ക്കുക
drawing	ഡ്രോയിംഗ്
dream	സ്വപ്നം
dress	വസ്ത്രധാരണം
drink	പാനീയം
drive	ഡ്രൈവ് ചെയ്യുക
driver	ഡ്രൈവർ
drop	ഡ്രോപ്പ്
drug	മരുന്ന്
dry	വരണ്ട
duck	ഡക്ക്
due	കാരണം
during	സമയത്ത്
dust	പൊടി
duty	കടമ
each	ഓരോന്നും
eager	ആകാംക്ഷയോടെ
ear	ചെവി
early	നേരത്തേ
earn	സമ്പാദിക്കുക
earnings	വരുമാനം
earth	ഭൂമി
ease	അനായാസം
easily	എളുപ്പത്തിൽ
east	കിഴക്ക്
eastern	കിഴക്ക്
easy	എളുപ്പമാണ്
eat	കഴിക്കുക
economic	സാമ്പത്തിക
economics	സാമ്പത്തികശാസ്ത്രം
economist	സാമ്പത്തിക ശാസ്ത്രജ്ഞൻ
economy	സമ്പദ്
edge	അഗ്രം
edition	പതിപ്പ്
editor	എഡിറ്റർ
educate	അഭ്യസിപ്പിക്കുന്നത്
education	വിദ്യാഭ്യാസം
educational	വിദ്യാഭ്യാസപരമായ
educator	അധ്യാപകൻ
effect	ഫലം
effective	ഫലപ്രദമായ
effectively	ഫലപ്രദമായി
efficiency	കാര്യക്ഷമത
efficient	കാര്യക്ഷമമായ
effort	പരിശ്രമം
egg	മുട്ട
eight	എട്ട്
either	ഒന്നുകിൽ
elderly	പ്രായമായവർ
elect	തിരഞ്ഞെടുത്തു
election	തിരഞ്ഞെടുപ്പ്
electric	വൈദ്യുത
electricity	വൈദ്യുതി
electronic	ഇലക്ട്രോണിക്
element	ഘടകം
elementary	പ്രാഥമിക
eliminate	ഇല്ലാതെയാക്കുവാൻ
elite	വരേണ്യവർഗം
else	വേറെ
elsewhere	മറ്റൊരിടത്ത്
e-mail	ഇ-മെയിൽ
embrace	പുണരുക
emerge	ഉദിക്കുക
emergency	അടിയന്തരാവസ്ഥ
emission	ഉദ്വമനം
emotion	വികാരം
emotional	വികാരപരമായ
emphasis	ഊന്നിപ്പറയല്
emphasize	പ്രാധാന്യം നൽകി
employ	നിയമിക്കുക
employee	ജീവനക്കാരൻ
employer	തൊഴിലുടമ
employment	തൊഴിൽ
empty	ശൂന്യമാണ്
enable	പ്രാപ്തമാക്കുക
encounter	ഏറ്റുമുട്ടൽ
encourage	പ്രോത്സാഹിപ്പിക്കുന്നു
end	അവസാനിക്കുന്നു
enemy	ശത്രു
energy	ർജ്ജം
enforcement	നടപ്പാക്കൽ
engage	ഇടപഴകുക
engine	എഞ്ചിൻ
engineer	എഞ്ചിനീയർ
engineering	എഞ്ചിനീയറിംഗ്
English	ഇംഗ്ലീഷ്
enhance	വർദ്ധിപ്പിക്കുക
enjoy	ആസ്വദിക്കൂ
enormous	വലിയ
enough	മതി
ensure	ഉറപ്പുവരുത്തുക
enter	പ്രവേശിക്കുക
enterprise	എന്റർപ്രൈസ്
entertainment	വിനോദം
entire	മുഴുവൻ
entirely	പൂർണ്ണമായും
entrance	പ്രവേശനം
entry	പ്രവേശനം
environment	പരിസ്ഥിതി
environmental	പരിസ്ഥിതി
episode	എപ്പിസോഡ്
equal	തുല്യ
equally	തുല്യ
equate	തുല്യമാക്കുക
equipment	ഉപകരണങ്ങൾ
era	യുഗം
error	പിശക്
escape	എസ്കേപ്പ്
especially	പ്രത്യേകിച്ചും
essay	ഉപന്യാസം
essential	അത്യാവശ്യം
essentially	അടിസ്ഥാനപരമായി
establish	സ്ഥാപിക്കുക
establishment	സ്ഥാപനം
estate	എസ്റ്റേറ്റ്
estimate	എസ്റ്റിമേറ്റ്
etc	തുടങ്ങിയവ
ethics	നീതിശാസ്ത്രം
ethnic	വംശീയ
European	യൂറോപ്യൻ
evaluate	വിലയിരുത്തുക
evaluation	മൂല്യനിർണ്ണയം
even	പോലും
evening	വൈകുന്നേരം
event	സംഭവം
eventually	ഒടുവിൽ
ever	എന്നേക്കും
every	ഓരോ
everybody	എല്ലാവരും
everyday	എല്ലാ ദിവസവും
everyone	എല്ലാവരും
everything	എല്ലാം
everywhere	എല്ലായിടത്തും
evidence	തെളിവ്
evolution	പരിണാമം
evolve	പരിണമിക്കുക
exact	കൃത്യം
exactly	കൃത്യമായി
examination	പരീക്ഷ
examine	പരിശോധിക്കുക
example	ഉദാഹരണം
exceed	കവിയുന്നു
excellent	മികച്ചത്
except	ഒഴികെ
exception	ഒഴിവാക്കൽ
exchange	കൈമാറ്റം
excite	ആവേശം
exciting	ആവേശകരമായ
executive	എക്സിക്യൂട്ടീവ്
exercise	വ്യായാമം
exhibit	പ്രദർശിപ്പിക്കുക
exhibition	പ്രദർശനം
exist	നിലനിൽക്കുന്നു
existence	അസ്തിത്വം
existing	നിലവിലുള്ള
expand	വികസിപ്പിക്കുക
expansion	വിപുലീകരണം
expect	പ്രതീക്ഷിക്കുന്നു
expectation	പ്രതീക്ഷ
expense	ചെലവ്
expensive	ചെലവേറിയത്
experience	അനുഭവം
experiment	പരീക്ഷണം
expert	വിദഗ്ദ്ധൻ
explain	വിശദീകരിക്കാൻ
explanation	വിശദീകരണം
explode	പൊട്ടിത്തെറിക്കുന്നു
explore	പര്യവേക്ഷണം ചെയ്യുക
explosion	സ്ഫോടനം
expose	തുറന്നുകാട്ടുക
exposure	സമ്പർക്കം
express	എക്സ്പ്രസ്
expression	ആവിഷ്കാരം
extend	നീട്ടുക
extension	വിപുലീകരണം
extensive	വിപുലമായ
extent	പരിധിവരെ
external	ബാഹ്യ
extra	അധിക
extraordinary	അസാധാരണമായ
extreme	അങ്ങേയറ്റം
extremely	അങ്ങേയറ്റം
eye	കണ്ണ്
fabric	തുണി
face	മുഖം
facility	സൗകര്യം
fact	വസ്തുത
factor	ഘടകം
factory	ഫാക്ടറി
faculty	ഫാക്കൽറ്റി
fade	മങ്ങുന്നു
fail	പരാജയപ്പെടുക
failure	പരാജയം
fair	ന്യായമായ
fairly	ന്യായമായും
faith	വിശ്വാസം
fall	വീഴുക
familiar	പരിചിതമായ
family	കുടുംബം
famous	പ്രസിദ്ധമായ
fan	ഫാൻ
fantasy	ഫാന്റസി
far	ബഹുദൂരം
farm	ഫാം
farmer	കർഷകൻ
fashion	ഫാഷൻ
fast	വേഗം
fat	കൊഴുപ്പ്
fate	വിധി
father	അച്ഛൻ
fault	തെറ്റ്
favor	പ്രീതി
favorite	പ്രിയപ്പെട്ട
fear	ഭയം
feature	സവിശേഷത
federal	ഫെഡറൽ
fee	ഫീസ്
feed	തീറ്റ
feel	അനുഭവപ്പെടുന്നു
feeling	തോന്നൽ
feet	അടി
fell	വീണു
fellow	സഹയാത്രികൻ
felt	തോന്നി
female	സ്ത്രീ
fence	വേലി
few	ചുരുക്കം
fewer	എണ്ണം കുറച്ച്
fiber	നാര്
fiction	ഫിക്ഷൻ
field	വയൽ
fifteen	പതിനഞ്ച്
fifth	അഞ്ചാമത്
fifty	അമ്പത്
fig	അത്തിപ്പഴം
fight	പോരാടുക
fighter	പോരാളി
fighting	യുദ്ധം ചെയ്യുന്നു
figure	ചിത്രം
file	ഫയൽ
fill	പൂരിപ്പിക്കുക
film	സിനിമ
final	അന്തിമ
finally	ഒടുവിൽ
finance	ധനകാര്യം
financial	സാമ്പത്തിക
find	കണ്ടെത്തുക
finding	കണ്ടെത്തുന്നു
fine	നന്നായി
finger	വിരല്
finish	പൂർത്തിയാക്കുക
fire	തീ
firm	ഉറച്ച
first	ആദ്യം
fish	മത്സ്യം
fishing	മത്സ്യബന്ധനം
fit	ഫിറ്റ്
fitness	ഫിറ്റ്നസ്
five	അഞ്ച്
fix	പരിഹരിക്കുക
flag	പതാക
flame	ജ്വാല
flat	ഫ്ലാറ്റ്
flavor	രസം
flee	ഓടിപ്പോകുക
flesh	മാംസം
flight	ഫ്ലൈറ്റ്
float	ഫ്ലോട്ട്
floor	തറ
flow	ഒഴുക്ക്
flower	പുഷ്പം
fly	പറക്കുക
focus	ഫോക്കസ്
folk	നാടൻ
follow	പിന്തുടരുക
following	താഴെ
food	ഭക്ഷണം
foot	കാൽ
football	ഫുട്ബോൾ
for	വേണ്ടി
force	ശക്തിയാണ്
foreign	വിദേശ
forest	വനം
forever	എന്നേക്കും
forget	മറക്കരുത്
form	ഫോം
formal	പചാരിക
formation	രൂപീകരണം
former	മുൻ
formula	സൂത്രവാക്യം
forth	മുന്നോട്ട്
fortune	ഭാഗ്യം
forward	മുന്നോട്ട്
found	കണ്ടെത്തി
foundation	അടിസ്ഥാനം
founder	സ്ഥാപകൻ
four	നാല്
fourth	നാലാമത്തെ
fraction	ഭിന്നസംഖ്യ
frame	ഫ്രെയിം
framework	ചട്ടക്കൂട്
free	സൗ ജന്യം
freedom	സ്വാതന്ത്ര്യം
freeze	മരവിപ്പിക്കുക
French	ഫ്രഞ്ച്
frequency	ആവൃത്തി
frequent	പതിവ്
frequently	കൂടെക്കൂടെ
fresh	പുതിയ
friend	സുഹൃത്ത്
friendly	സൗഹൃദപരമായ
friendship	സൗഹൃദം
from	മുതൽ
front	മുന്നിൽ
fruit	പഴം
frustration	നിരാശ
fuel	ഇന്ധനം
full	നിറഞ്ഞ
fully	പൂർണ്ണമായി
fun	രസകരമായ
function	പ്രവർത്തനം
fund	ഫണ്ട്
fundamental	അടിസ്ഥാനപരമായ
funding	ധനസഹായം
funeral	ശവസംസ്കാരം
funny	തമാശ
furniture	ഫർണിച്ചർ
furthermore	കൂടുതൽ
future	ഭാവി
gain	നേട്ടം
galaxy	താരാപഥം
gallery	ഗാലറി
game	കളി
gang	സംഘം
gap	വിടവ്
garage	ഗാരേജ്
garden	തോട്ടം
garlic	വെളുത്തുള്ളി
gas	ഗ്യാസ്
gate	ഗേറ്റ്
gather	കൂട്ടിച്ചേർക്കും
gave	കൊടുത്തു
gay	ഗേ
gaze	നോക്കുക
gear	ഗിയര്
gender	ലിംഗഭേദം
gene	ജീൻ
general	പൊതുവായ
generally	പൊതുവേ
generate	സൃഷ്ടിക്കുക
generation	തലമുറ
genetic	ജനിതക
gentle	സൗമ്യമായ
gentleman	മാന്യൻ
gently	സentlyമ്യമായി
German	ജർമ്മൻ
gesture	ആംഗ്യം
get	നേടുക
ghost	പ്രേതം
giant	ഭീമൻ
gift	സമ്മാനം
gifted	സമ്മാനിച്ചത്
girl	പെൺകുട്ടി
girlfriend	കാമുകി
give	കൊടുക്കുക
given	നൽകി
glad	സന്തോഷിപ്പിക്കുന്നു
glance	നോട്ടം
glass	ഗ്ലാസ്
global	ആഗോള
glove	കയ്യുറ
go	പോകുക
goal	ലക്ഷ്യം
God	ദൈവം
gold	സ്വർണം
golden	പൊൻ
golf	ഗോൾഫ്
gone	പോയി
good	നല്ല
got	ലഭിച്ചു
govern	ഭരിക്കുന്നു
government	സർക്കാർ
governor	ഗവർണർ
grab	പിടിക്കുക
grade	ഗ്രേഡ്
gradually	ക്രമേണ
graduate	ബിരുദധാരി
grain	ധാന്യം
grand	ഗംഭീരം
grandfather	മുത്തച്ഛൻ
grandmother	മുത്തശ്ശി
grant	അനുവദിക്കുക
grass	പുല്ല്
grave	കുഴിമാടം
gray	ചാരനിറം
great	വലിയ
greatest	ഏറ്റവും വലിയ
green	പച്ച
grew	വളർന്നു
grocery	പലചരക്ക്
ground	നിലം
group	ഗ്രൂപ്പ്
grow	വളരുക
growing	വളരുന്നു
growth	വളർച്ച
guarantee	ഗ്യാരണ്ടി
guard	കാവൽക്കാരൻ
guess	ഊഹിക്കുക
guest	അതിഥി
guide	വഴികാട്ടി
guideline	മാർഗരേഖ
guilty	കുറ്റവാളി
gun	തോക്ക്
guy	ആള്‍
habit	ശീലം
habitat	ആവാസവ്യവസ്ഥ
had	ഉണ്ടായിരുന്നു
hair	മുടി
half	പകുതി
hall	ഹാൾ
hand	കൈ
handful	കൈ നിറയ
handle	കൈകാര്യം ചെയ്യുക
hang	തൂക്കുക
happen	സംഭവിക്കുക
happy	സന്തോഷം
hard	കഠിനമായ
hardly	കഷ്ടിച്ച്
has	ഉണ്ട്
hat	തൊപ്പി
hate	വെറുക്കുന്നു
have	ഉണ്ട്
he	അവൻ
head	തല
headline	തലക്കെട്ട്
headquarters	ആസ്ഥാനം
health	ആരോഗ്യം
healthy	ആരോഗ്യമുള്ള
hear	കേൾക്കുക
heard	കേട്ടു
hearing	കേൾവി
heart	ഹൃദയം
heat	ചൂട്
heaven	സ്വർഗ്ഗം
heavily	കനത്ത
heavy	കനത്ത
heel	കുതികാൽ
height	ഉയരം
held	നടന്ന
helicopter	ഹെലികോപ്റ്റർ
hell	നരകം
hello	ഹലോ
help	സഹായം
helpful	സഹായകരമായ
her	അവളുടെ
here	ഇവിടെ
heritage	പൈതൃകം
hero	കഥാനായകന്
herself	സ്വയം
hey	ഹേയ്
hi	ഹായ്
hide	മറയ്ക്കുക
high	ഉയർന്ന
highlight	ഹൈലൈറ്റ്
highly	വളരെ
highway	ഹൈവേ
hill	മലയോര
him	അവനെ
himself	സ്വയം
hip	ഇടുപ്പ്
hire	കൂലി
his	അദ്ദേഹത്തിന്റെ
historian	ചരിത്രകാരൻ
historic	ചരിത്രപരമായ
historical	ചരിത്രപരമായ
history	ചരിത്രം
hit	ഹിറ്റ്
hold	പിടിക്കുക
hole	ദ്വാരം
holiday	അവധി
holy	വിശുദ്ധ
home	വീട്ടിൽ
homeless	വീടില്ലാത്തവർ
honest	സത്യസന്ധൻ
honey	തേന്
honor	ബഹുമാനം
hope	പ്രതീക്ഷിക്കുന്നു
horizon	ചക്രവാളം
horror	ഭയങ്കരതം
horse	കുതിര
hospital	ആശുപത്രി
host	ആതിഥേയ
hot	ചൂടുള്ള
hotel	ഹോട്ടൽ
hour	മണിക്കൂർ
house	വീട്
household	ഗാർഹിക
housing	പാർപ്പിട
how	എങ്ങനെ
however	എന്നിരുന്നാലും
huge	വൻ
human	മനുഷ്യൻ
humor	ഹാസ്യം
hundred	നൂറ്
hungry	വിശക്കുന്നു
hunt	വേട്ട
hunter	വേട്ടക്കാരൻ
hunting	വേട്ടയാടൽ
hurry	വേഗം
hurt	വേദനിപ്പിച്ചു
husband	ഭർത്താവ്
hypothesis	സിദ്ധാന്തം
I	ഐ
ice	ഐസ്
idea	ആശയം
ideal	ആദർശം
identification	തിരിച്ചറിയൽ
identify	തിരിച്ചറിയുക
identity	ഐഡന്റിറ്റി
ie	അതായത്
if	എങ്കിൽ
ignore	അവഗണിക്കുക
ill	അസുഖം
illegal	നിയമവിരുദ്ധം
illness	അസുഖം
illustrate	ചിത്രീകരിക്കുക
image	ചിത്രം
imagination	ഭാവന
imagine	സങ്കൽപ്പിക്കുക
immediate	ഉടനടി
immediately	ഉടനെ
immigrant	കുടിയേറ്റക്കാരൻ
immigration	കുടിയേറ്റം
impact	ആഘാതം
implement	നടപ്പിലാക്കുക
implication	അർത്ഥം
imply	സൂചിപ്പിക്കുന്നു
importance	പ്രാധാന്യം
important	പ്രധാനപ്പെട്ട
impose	ചുമത്തുന്നതു
impossible	അസാധ്യമാണ്
impress	മതിപ്പുളവാക്കുക
impression	മതിപ്പ്
impressive	ആകർഷണീയമായ
improve	മെച്ചപ്പെടുത്തുക
improvement	മെച്ചപ്പെടുത്തൽ
in	ൽ
incentive	പ്രോത്സാഹനം
inch	ഇഞ്ച്
incident	സംഭവം
include	ഉൾപ്പെടുന്നു
including	ഉൾപ്പെടെ
income	വരുമാനം
incorporate	സംയോജിപ്പിക്കുക
increase	വർധിപ്പിക്കുക
increased	വർദ്ധിച്ചു
increasing	വർദ്ധിച്ചുവരുന്ന
increasingly	വർദ്ധിച്ചുവരുന്ന
incredible	അവിശ്വസനീയമായ
indeed	തീർച്ചയായും
independence	സ്വാതന്ത്ര്യം
independent	സ്വതന്ത്ര
index	സൂചിക
Indian	ഇന്ത്യൻ
indicate	സൂചിപ്പിക്കുക
indication	സൂചന
individual	വ്യക്തി
industrial	വ്യാവസായിക
industry	വ്യവസായം
infant	ശിശു
infection	അണുബാധ
inflation	പണപ്പെരുപ്പം
influence	സ്വാധീനം
inform	അറിയിക്കുക
information	വിവരങ്ങൾ
ingredient	ഘടകം
initial	പ്രാരംഭം
initially	തുടക്കത്തിൽ
initiative	മുൻകൈ
injury	പരിക്ക്
inner	അകത്തെ
innocent	നിരപരാധി
inquiry	അന്വേഷണം
insect	പ്രാണി
inside	അകത്ത്
insight	ഉൾക്കാഴ്ച
insist	നിർബന്ധിക്കുക
inspire	പ്രചോദിപ്പിക്കുക
install	ഇൻസ്റ്റാൾ ചെയ്യുക
instance	ഉദാഹരണം
instant	തൽക്ഷണം
instead	പകരം
institution	സ്ഥാപനം
institutional	സ്ഥാപനപരമായ
instruction	നിർദ്ദേശം
instructor	പരിശീലകൻ
instrument	ഉപകരണം
insurance	ഇൻഷുറൻസ്
intellectual	ബൗദ്ധിക
intelligence	ബുദ്ധി
intend	ഉദ്ദേശിക്കുന്നു
intense	തീവ്രമായ
intensity	തീവ്രത
intention	ഉദ്ദേശം
interaction	ഇടപെടൽ
interest	പലിശ
interested	താൽപ്പര്യമുണ്ട്
interesting	രസകരമായ
internal	ആന്തരിക
international	അന്താരാഷ്ട്ര
Internet	ഇന്റർനെറ്റ്
interpret	വ്യാഖ്യാനിക്കുക
interpretation	വ്യാഖ്യാനം
intervention	ഇടപെടൽ
interview	അഭിമുഖം
into	ഉള്ളിലേക്ക്
introduce	പരിചയപ്പെടുത്തുക
introduction	ആമുഖം
invasion	അധിനിവേശം
invent	കണ്ടുപിടിക്കുക
invest	നിക്ഷേപിക്കുക
investigate	അന്വേഷിക്കുക
investigation	അന്വേഷണം
investigator	അന്വേഷകൻ
investment	നിക്ഷേപം
investor	നിക്ഷേപകൻ
invite	ക്ഷണിക്കുക
involve	ഉൾപ്പെടുന്നു
involved	ഉൾപ്പെട്ടിരിക്കുന്നത്
involvement	ഇടപെടൽ
Iraqi	ഇറാഖി
Irish	ഐറിഷ്
iron	ഇരുമ്പ്
is	ആണ്
Islamic	ഇസ്ലാമിക
island	ദ്വീപ്
Israeli	ഇസ്രായേലി
issue	ഇഷ്യൂ
it	അത്
Italian	ഇറ്റാലിയൻ
item	ഇനം
its	അതിന്റെ
itself	സ്വയം
jacket	ജാക്കറ്റ്
jail	ജയിൽ
Japanese	ജാപ്പനീസ്
jet	ജെറ്റ്
Jew	ജൂതൻ
Jewish	ജൂതൻ
job	ജോലി
join	ചേരുക
joint	സംയുക്ത
joke	തമാശ
journal	ജേണൽ
journalist	പത്രപ്രവർത്തകൻ
journey	യാത്രയെ
joy	സന്തോഷം
judge	ന്യായാധിപൻ
judgment	വിധി
juice	ജ്യൂസ്
jump	ചാടുക
junior	ഇളമുറയായ
jury	ജൂറി
just	വെറും
justice	നീതി
justify	ന്യായീകരിക്കുക
keep	സൂക്ഷിക്കുക
kept	സൂക്ഷിച്ചു
key	കീ
kick	തൊഴി
kid	കൊച്ചു
kill	കൊല്ലുക
killer	കൊലയാളി
killing	കൊല്ലുന്നു
kind	ദയ
king	രാജാവ്
kiss	ചുംബിക്കുക
kitchen	അടുക്കള
knee	മുട്ട്
knew	അറിയാമായിരുന്നു
knife	കത്തി
knock	മുട്ടുക
know	അറിയാം
knowledge	അറിവ്
lab	ലാബ്
label	ലേബൽ
labor	അധ്വാനം
laboratory	ലബോറട്ടറി
lack	അഭാവം
lady	സ്ത്രീ
lake	തടാകം
land	ഭൂമി
landscape	ഭൂപ്രകൃതി
language	ഭാഷ
lap	മടി
large	വലിയ
largely	വലിയതോതിൽ
last	അവസാനത്തെ
late	വൈകി
later	പിന്നീട്
Latin	ലാറ്റിൻ
latter	പിന്നത്തെ
laugh	ചിരിക്കുക
launch	വിക്ഷേപണം
law	നിയമം
lawn	പുൽത്തകിടി
lawsuit	കേസ്
lawyer	അഭിഭാഷകൻ
lay	കിടന്നു
layer	പാളി
lead	ലീഡ്
leader	നേതാവ്
leadership	നേതൃത്വം
leading	നയിക്കുന്നത്
leaf	ഇല
league	ലീഗ്
lean	മെലിഞ്ഞ
learn	പഠിക്കുക
learning	പഠിക്കുന്നത്
least	കുറഞ്ഞത്
leather	തുകൽ
leave	വിട്ടേക്കുക
led	എൽഇഡി
left	ഇടത്തെ
leg	കാല്
legacy	പൈതൃകം
legal	നിയമപരമായ
legend	ഇതിഹാസം
legislation	നിയമനിർമ്മാണം
legitimate	നിയമാനുസൃതം
lemon	നാരങ്ങ
length	നീളം
less	കുറവ്
lesson	പാഠം
let	അനുവദിക്കുക
letter	കത്ത്
level	നില
liberal	ലിബറൽ
library	പുസ്തകശാല
license	ലൈസൻസ്
lie	കള്ളം
life	ജീവിതം
lifestyle	ജീവിതശൈലി
lifetime	ജീവിതകാലം
lift	ലിഫ്റ്റ്
light	വെളിച്ചം
like	പോലെ
likely	സാധ്യത
limit	പരിധി
limitation	പരിമിതപ്പെടുത്താതെ
limited	പരിമിതമാണ്
line	ലൈൻ
link	ലിങ്ക്
lip	അധരം
liquid	ദ്രാവക
list	പട്ടിക
listen	കേൾക്കുക
literally	അക്ഷരാർത്ഥത്തിൽ
literary	സാഹിത്യ
literature	സാഹിത്യം
little	അല്പം
live	തത്സമയം
living	ജീവിക്കുന്നത്
load	ലോഡ്
loan	വായ്പ
local	പ്രാദേശിക
locate	കണ്ടെത്തുക
location	സ്ഥാനം
lock	ലോക്ക്
log	ലോഗ്
lone	ഒറ്റയ്ക്ക്
long	നീളമുള്ള
long-term	ദീർഘകാല
look	നോക്കൂ
loose	അയഞ്ഞ
lose	നഷ്ടപ്പെടും
loss	നഷ്ടം
lost	നഷ്ടപ്പെട്ടു
lot	ഭൂരിഭാഗം
lots	ധാരാളം
loud	ഉച്ചത്തിൽ
love	സ്നേഹം
lovely	മനോഹരം
lover	കാമുകൻ
low	കുറഞ്ഞ
lower	താഴത്തെ
luck	ഭാഗ്യം
lucky	ഭാഗ്യവാൻ
lunch	ഉച്ചഭക്ഷണം
lung	ശാസകോശം
machine	യന്ത്രം
mad	ഭ്രാന്തൻ
made	ഉണ്ടാക്കി
magazine	മാസിക
magnet	കാന്തം
mail	മെയിൽ
main	പ്രധാന
mainly	പ്രധാനമായും
maintain	പരിപാലിക്കുക
maintenance	പരിപാലനം
major	പ്രധാന
majority	ഭൂരിപക്ഷം
make	ഉണ്ടാക്കുക
maker	നിർമ്മാതാവ്
makeup	മേക്ക് അപ്പ്
male	ആൺ
mall	മാൾ
man	മനുഷ്യൻ
manage	കൈകാര്യം ചെയ്യുക
management	മാനേജ്മെന്റ്
manager	മാനേജർ
manner	വിധത്തിൽ
manufacturer	നിർമ്മാതാവ്
manufacturing	ഉത്പാദനം
many	നിരവധി
map	ഭൂപടം
margin	മാർജിൻ
mark	അടയാളം
market	വിപണി
marketing	വിപണനം
marriage	വിവാഹം
married	വിവാഹിതനായി
marry	വിവാഹം
mask	മാസ്ക്
mass	പിണ്ഡം
massive	കൂറ്റൻ
master	മാസ്റ്റർ
match	പൊരുത്തം
material	മെറ്റീരിയൽ
math	ഗണിതം
matter	കാര്യം
may	മെയ്
maybe	ഒരുപക്ഷേ
mayor	മേയർ
me	എന്നെ
meal	ഭക്ഷണം
mean	അർത്ഥം
meaning	അർത്ഥം
meant	ഉദ്ദേശിച്ചത്
meanwhile	അതേസമയം
measure	അളക്കുക
measurement	അളവ്
meat	മാംസം
mechanism	സംവിധാനം
media	മാധ്യമങ്ങൾ
medical	മെഡിക്കൽ
medication	മരുന്ന്
medicine	മരുന്ന്
medium	ഇടത്തരം
meet	കണ്ടുമുട്ടുക
meeting	യോഗം
melody	ഈണം
member	അംഗം
membership	അംഗത്വം
memory	മെമ്മറി
men	പുരുഷന്മാർ
mental	മാനസിക
mention	പരാമർശിക്കുക
menu	മെനു
mere	വെറും
merely	കേവലം
mess	കുഴപ്പം
message	സന്ദേശം
metal	ലോഹം
meter	മീറ്റർ
method	രീതി
Mexican	മെക്സിക്കൻ
middle	മധ്യത്തിൽ
might	ശക്തി
mile	നാഴിക
military	സൈനിക
milk	പാൽ
million	ദശലക്ഷം
mind	മനസ്സ്
mine	എന്റെ
minister	മന്ത്രി
minor	പ്രായപൂർത്തിയാകാത്ത
minority	ന്യൂനപക്ഷം
minute	മിനിറ്റ്
miracle	അത്ഭുതം
mirror	കണ്ണാടി
miss	ഉന്നംതെറ്റുക
missile	മിസൈൽ
mission	ദൗത്യം
mistake	തെറ്റ്
mix	ഇളക്കുക
mixture	മിശ്രിതം
mode	മോഡ്
model	മോഡൽ
moderate	മിതത്വം
modern	ആധുനിക
modest	എളിമയുള്ള
molecule	തന്മാത്ര
mom	അമ്മ
moment	നിമിഷം
money	പണം
monitor	മോണിറ്റർ
month	മാസം
mood	മാനസികാവസ്ഥ
moon	ചന്ദ്രൻ
moral	ധാർമ്മിക
more	കൂടുതൽ
moreover	കൂടാതെ
morning	രാവിലെ
mortgage	ജാമ്യം
most	ഏറ്റവും
mostly	കൂടുതലും
mother	അമ്മ
motion	ചലനം
motivation	പ്രചോദനം
motor	മോട്ടോർ
mount	മ .ണ്ട്
mountain	മല
mouse	മൗസ്
mouth	വായ
move	നീക്കുക
movement	പ്രസ്ഥാനം
movie	സിനിമ
Mr	മിസ്റ്റർ
Mrs	ശ്രീമതി
Ms	മിസ്
much	വളരെ
multiple	ഒന്നിലധികം
multiply	പെരുകുക
murder	കൊലപാതകം
muscle	മാംസപേശി
museum	മ്യൂസിയം
music	സംഗീതം
musical	സംഗീത
musician	സംഗീതജ്ഞൻ
Muslim	മുസ്ലീം
must	വേണം
mutual	പരസ്പരമുള്ള
my	എന്റെ
myself	സ്വയം
mystery	നിഗൂ .ത
myth	കെട്ടുകഥ
naked	നഗ്നനായി
name	പേര്
narrative	ആഖ്യാനം
narrow	ഇടുങ്ങിയ
nation	രാഷ്ട്രം
national	ദേശീയ
native	സ്വദേശി
natural	സ്വാഭാവികം
naturally	സ്വാഭാവികമായും
nature	പ്രകൃതി
near	സമീപം
nearby	സമീപത്ത്
nearly	ഏതാണ്ട്
necessarily	അനിവാര്യമായും
necessary	അത്യാവശ്യം
neck	കഴുത്ത്
need	ആവശ്യം
negative	നെഗറ്റീവ്
negotiate	ചർച്ച
negotiation	ചർച്ച
neighbor	അയൽക്കാരൻ
neighborhood	അയൽപ്പക്കം
neither	അല്ല
nerve	നാഡി
nervous	നാഡീവ്യൂഹം
net	വല
network	നെറ്റ്‌വർക്ക്
never	ഒരിക്കലും
nevertheless	എന്നിരുന്നാലും
new	പുതിയ
newly	പുതുതായി
news	വാർത്ത
newspaper	പത്രം
next	അടുത്തത്
nice	നല്ല
night	രാത്രി
nine	ഒമ്പത്
no	ഇല്ല
nobody	ആരും
nod	തലയാട്ടുക
noise	ശബ്ദം
nomination	നാമനിർദ്ദേശം
none	ഒന്നുമില്ല
nonetheless	എന്നിരുന്നാലും
noon	ഉച്ച
nor	അല്ല
normal	സാധാരണ
normally	സാധാരണ
north	വടക്ക്
northern	വടക്കൻ
nose	മൂക്ക്
not	അല്ല
note	കുറിപ്പ്
nothing	ഒന്നുമില്ല
notice	നോട്ടീസ്
notion	ആശയം
noun	നാമം
novel	നോവൽ
now	ഇപ്പോൾ
nowhere	ഒരിടത്തുമില്ല
n’t	അല്ല
nuclear	ആണവ
number	നമ്പർ
numeral	സംഖ്യ
numerous	നിരവധി
nurse	നഴ്സ്
nut	നട്ട്
object	വസ്തു
objective	വസ്തുനിഷ്ഠം
obligation	ബാധ്യത
observation	നിരീക്ഷണം
observe	നിരീക്ഷിക്കുക
observer	നിരീക്ഷകൻ
obtain	നേടുക
obvious	വ്യക്തമാണ്
obviously	സ്പഷ്ടമായി
occasion	അവസരത്തിൽ
occasionally	ഇടയ്ക്കിടെ
occupation	തൊഴിൽ
occupy	അധിനിവേശം
occur	സംഭവിക്കുന്നു
ocean	സമുദ്രം
odd	വിചിത്രമായ
odds	സാധ്യതകൾ
of	യുടെ
off	ഓഫ്
offense	കുറ്റമായാണ്
offensive	ആക്രമണാത്മക
offer	ഓഫർ
office	ഓഫീസ്
officer	ഉദ്യോഗസ്ഥൻ
official	ദ്യോഗിക
often	പലപ്പോഴും
oh	ഓ
oil	എണ്ണ
ok	ശരി
okay	ശരി
old	പഴയത്
Olympic	ഒളിമ്പിക്
on	ന്
once	ഒരിക്കല്
one	ഒന്ന്
ongoing	തുടരുന്നു
onion	ഉള്ളി
online	ഓൺലൈൻ
only	മാത്രം
onto	ന്
open	തുറക്കുക
opening	തുറക്കുന്നു
operate	പ്രവർത്തിക്കുക
operating	പ്രവർത്തിക്കുന്നത്
operation	പ്രവർത്തനം
operator	ഓപ്പറേറ്റർ
opinion	അഭിപ്രായം
opponent	എതിരാളി
opportunity	അവസരം
oppose	എതിർക്കുക
opposite	എതിർവശത്ത്
opposition	എതിർപ്പ്
option	ഓപ്ഷൻ
or	അഥവാ
orange	ഓറഞ്ച്
order	ഓർഡർ
ordinary	സാധാരണ
organ	അവയവം
organic	ജൈവ
organization	സംഘടന
organize	സംഘടിപ്പിക്കുക
orientation	ഓറിയന്റേഷൻ
origin	ഉത്ഭവം
original	ഒറിജിനൽ
originally	യഥാർത്ഥത്തിൽ
other	മറ്റ്
others	മറ്റുള്ളവർ
otherwise	അല്ലാത്തപക്ഷം
ought	വേണം
our	നമ്മുടെ
ourselves	സ്വയം
out	പുറത്ത്
outcome	ഫലം
outside	പുറത്ത്
oven	അടുപ്പ്
over	ഓവർ
overall	മൊത്തത്തിൽ
overcome	മറികടക്കുക
overlook	അവഗണിക്കുക
owe	കടപ്പെട്ടിരിക്കുന്നു
own	സ്വന്തം
owner	ഉടമ
oxygen	ഓക്സിജൻ
pace	പേസ്
pack	പായ്ക്ക്
package	പാക്കേജ്
page	പേജ്
pain	വേദന
painful	വേദനാജനകമായ
paint	പെയിന്റ്
painter	ചിത്രകാരൻ
painting	പെയിന്റിംഗ്
pair	ജോഡി
pale	വിളറിയ
Palestinian	പലസ്തീൻ
palm	ഈന്തപ്പന
pan	പാൻ
panel	പാനൽ
pant	പാന്റ്
paper	പേപ്പർ
paragraph	ഖണ്ഡിക
parent	രക്ഷിതാവ്
park	പാർക്ക്
parking	പാർക്കിംഗ്
part	ഭാഗം
participant	പങ്കാളി
participate	പങ്കെടുക്കുക
participation	പങ്കാളിത്തം
particular	പ്രത്യേക
particularly	പ്രത്യേകിച്ചും
partly	ഭാഗികമായി
partner	പങ്കാളി
partnership	പങ്കാളിത്തം
party	പാർട്ടി
pass	പാസ്
passage	കടന്നുപോകൽ
passenger	യാത്രക്കാരൻ
passion	അഭിനിവേശം
past	കഴിഞ്ഞ
patch	പാച്ച്
path	പാത
patient	ക്ഷമ
pattern	മാതൃക
pause	താൽക്കാലികമായി നിർത്തുക
pay	പണം
payment	പേയ്മെന്റ്
PC	പി.സി.
peace	സമാധാനം
peak	കൊടുമുടി
peer	സമപ്രായക്കാരൻ
penalty	പിഴ
people	ജനങ്ങൾ
pepper	കുരുമുളക്
per	ഓരോ
perceive	ഗ്രഹിക്കുക
percentage	ശതമാനം
perception	ധാരണ
perfect	തികഞ്ഞ
perfectly	തികച്ചും
perform	നിർവഹിക്കുക
performance	പ്രകടനം
perhaps	ഒരുപക്ഷേ
period	കാലയളവ്
permanent	സ്ഥിരമായ
permission	അനുമതി
permit	അനുമതി
person	വ്യക്തി
personal	വ്യക്തിപരമായ
personality	വ്യക്തിത്വം
personally	വ്യക്തിപരമായി
personnel	ഉദ്യോഗസ്ഥർ
perspective	കാഴ്ചപ്പാട്
persuade	പ്രേരിപ്പിക്കുക
pet	വളർത്തുമൃഗങ്ങൾ
phase	ഘട്ടം
phenomenon	പ്രതിഭാസം
philosophy	തത്ത്വചിന്ത
phone	ഫോൺ
photo	ഫോട്ടോ
photograph	ഫോട്ടോ
photographer	ഫോട്ടോഗ്രാഫർ
phrase	പദപ്രയോഗം
physical	ശാരീരിക
physically	ശാരീരികമായി
physician	വൈദ്യൻ
piano	പിയാനോ
pick	പിക്ക്
picture	ചിത്രം
pie	പൈ
piece	കഷണം
pile	മരത്തൂണ്
pilot	പൈലറ്റ്
pine	പൈൻമരം
pink	പിങ്ക്
pipe	പൈപ്പ്
pitch	പിച്ച്
place	സ്ഥലം
plain	പ്ലെയിൻ
plan	പദ്ധതി
plane	വിമാനം
planet	ഗ്രഹം
planning	ആസൂത്രണം
plant	ചെടി
plastic	പ്ലാസ്റ്റിക്
plate	പാത്രം
platform	പ്ലാറ്റ്ഫോം
play	കളിക്കുക
player	കളിക്കാരൻ
please	ദയവായി
pleasure	ആനന്ദം
plenty	ധാരാളം
plot	പ്ലോട്ട്
plural	ബഹുവചനം
plus	പ്ലസ്
PM	പി.എം.
pocket	പോക്കറ്റ്
poem	കവിത
poet	കവി
poetry	കവിത
point	പോയിന്റ്
pole	ധ്രുവം
police	പോലീസ്
policy	നയം
political	രാഷ്ട്രീയ
politically	രാഷ്ട്രീയമായി
politician	രാഷ്ട്രീയക്കാരൻ
politics	രാഷ്ട്രീയം
poll	വോട്ടെടുപ്പ്
pollution	അശുദ്ധമാക്കല്
pool	കുളം
poor	പാവം
pop	പോപ്പ്
popular	ജനപ്രിയമായ
populate	ജനസംഖ്യ
population	ജനസംഖ്യ
porch	പൂമുഖം
port	തുറമുഖം
portion	ഭാഗം
portrait	ഛായാചിത്രം
portray	ചിത്രീകരിക്കുക
pose	പോസ് ചെയ്യുക
position	സ്ഥാനം
positive	പോസിറ്റീവ്
possess	കൈവശം വയ്ക്കുക
possibility	സാധ്യത
possible	സാധ്യമാണ്
possibly	ഒരുപക്ഷേ
post	പോസ്റ്റ്
pot	കലം
potato	ഉരുളക്കിഴങ്ങ്
potential	സാധ്യതയുള്ള
potentially	സാധ്യതയുള്ളത്
pound	പൗണ്ട്
pour	പകരും
poverty	ദാരിദ്ര്യം
powder	പൊടി
power	ശക്തി
powerful	ശക്തമായ
practical	പ്രായോഗികം
practice	പരിശീലിക്കുക
pray	പ്രാർത്ഥിക്കുക
prayer	പ്രാർത്ഥന
precisely	കൃത്യമായും
predict	പ്രവചിക്കുക
prefer	ഇഷ്ടപ്പെടുന്നു
preference	മുൻഗണന
pregnancy	ഗർഭം
pregnant	ഗർഭിണി
preparation	തയ്യാറെടുപ്പ്
prepare	തയ്യാറാക്കുക
prescription	കുറിപ്പടി
presence	സാന്നിദ്ധ്യം
present	വർത്തമാന
presentation	അവതരണം
preserve	സംരക്ഷിക്കുക
president	പ്രസിഡന്റ്
presidential	പ്രസിഡന്റ്
press	അമർത്തുക
pressure	സമ്മർദ്ദം
pretend	നടിക്കുക
pretty	സുന്ദരി
prevent	തടയാൻ
previous	മുമ്പത്തെ
previously	മുമ്പ്
price	വില
pride	അഹംഭാവം
priest	പുരോഹിതൻ
primarily	പ്രാഥമികമായി
primary	പ്രാഥമിക
prime	പ്രൈം
principal	പ്രിൻസിപ്പൽ
principle	തത്വം
print	അച്ചടിക്കുക
prior	മുമ്പ്
priority	മുൻഗണന
prison	ജയിൽ
prisoner	തടവുകാരൻ
privacy	സ്വകാര്യത
private	സ്വകാര്യ
probable	സാധ്യതയുള്ളത്
probably	ഒരുപക്ഷേ
problem	പ്രശ്നം
procedure	നടപടിക്രമം
proceed	തുടരുക
process	പ്രക്രിയ
produce	ഉൽപ്പാദിപ്പിക്കുക
producer	നിർമ്മാതാവ്
product	ഉൽപ്പന്നം
production	ഉത്പാദനം
profession	തൊഴിൽ
professional	പ്രൊഫഷണൽ
professor	പ്രൊഫസർ
profile	പ്രൊഫൈൽ
profit	ലാഭം
program	പ്രോഗ്രാം
progress	പുരോഗതി
project	പദ്ധതി
prominent	പ്രമുഖൻ
promise	വാഗ്ദാനം
promote	പ്രോത്സാഹിപ്പിക്കുക
prompt	ഉടനടി
proof	തെളിവ്
proper	ഉചിതമായ
properly	ശരിയായി
property	സ്വത്ത്
proportion	അനുപാതം
proposal	നിർദ്ദേശം
propose	നിർദ്ദേശിക്കുക
proposed	നിർദ്ദേശിച്ചു
prosecutor	പ്രോസിക്യൂട്ടർ
prospect	പ്രതീക്ഷ
protect	സംരക്ഷിക്കുക
protection	സംരക്ഷണം
protein	പ്രോട്ടീൻ
protest	പ്രതിഷേധം
proud	അഭിമാനിക്കുന്നു
prove	തെളിയിക്കുക
provide	നൽകാൻ
provider	ദാതാവ്
province	പ്രവിശ്യ
provision	വ്യവസ്ഥ
psychological	മനlogicalശാസ്ത്രപരമായ
psychologist	മന psychoശാസ്ത്രജ്ഞൻ
psychology	മന psychoശാസ്ത്രം
public	പൊതു
publication	പ്രസിദ്ധീകരണം
publicly	പരസ്യമായി
publish	പ്രസിദ്ധീകരിക്കുക
publisher	പ്രസാധകൻ
pull	വലിക്കുക
punishment	ശിക്ഷ
purchase	വാങ്ങൽ
pure	ശുദ്ധമായ
purpose	ഉദ്ദേശ്യം
pursue	പിന്തുടരുക
push	തള്ളുക
put	വെച്ചു
qualify	യോഗ്യത നേടുക
quality	ഗുണമേന്മയുള്ള
quart	ക്വാർട്ട്
quarter	പാദത്തിൽ
quarterback	ക്വാർട്ടർബാക്ക്
question	ചോദ്യം
quick	വേഗം
quickly	വേഗം
quiet	ശാന്തമായി
quietly	നിശബ്ദമായി
quit	ഉപേക്ഷിക്കുക
quite	തികച്ചും
quote	ഉദ്ധരണി
quotient	ഉദ്ധരണി
race	വംശം
racial	വംശീയ
radical	തീവ്രമായ
radio	റേഡിയോ
rail	റെയിൽ
rain	മഴ
raise	ഉയർത്തുക
ran	ഓടി
range	ശ്രേണി
rank	റാങ്ക്
rapid	ദ്രുതഗതിയിലുള്ള
rapidly	അതിവേഗം
rare	അപൂർവ്വമായി
rarely	അപൂർവ്വമായി
rate	നിരക്ക്
rather	പകരം
rating	റേറ്റിംഗ്
ratio	അനുപാതം
raw	അസംസ്കൃത
reach	എത്തുക
react	പ്രതികരിക്കുക
reaction	പ്രതികരണം
read	വായിക്കുക
reader	വായനക്കാരൻ
reading	വായന
ready	തയ്യാറാണ്
real	യഥാർത്ഥ
reality	യാഥാർത്ഥ്യം
realize	തിരിച്ചറിയുക
really	ശരിക്കും
reason	കാരണം
reasonable	ന്യായമായ
recall	തിരിച്ചുവിളിക്കുക
receive	സ്വീകരിക്കുക
recent	സമീപകാലത്ത്
recently	അടുത്തിടെ
recipe	പാചകക്കുറിപ്പ്
recognition	അംഗീകാരം
recognize	തിരിച്ചറിയുക
recommend	ശുപാർശ ചെയ്യുന്നു
recommendation	ശുപാർശ
record	റെക്കോർഡ്
recording	റെക്കോർഡിംഗ്
recover	വീണ്ടെടുക്കുക
recovery	വീണ്ടെടുക്കൽ
recruit	റിക്രൂട്ട് ചെയ്യുക
red	ചുവപ്പ്
reduce	കുറയ്ക്കുക
reduction	കുറയ്ക്കൽ
refer	റഫർ ചെയ്യുക
reference	റഫറൻസ്
reflect	പ്രതിഫലിപ്പിക്കുക
reflection	പ്രതിഫലനം
reform	പുനഃസംഘടന
refugee	അഭയാർത്ഥി
refuse	നിരസിക്കുക
regard	പരിഗണിക്കുക
regarding	സംബന്ധിച്ച്
regardless	പരിഗണിക്കാതെ
regime	ഭരണകൂടം
region	പ്രദേശം
regional	പ്രാദേശിക
register	രജിസ്റ്റർ ചെയ്യുക
regular	പതിവ്
regularly	പതിവായി
regulate	നിയന്ത്രിക്കുക
regulation	നിയന്ത്രണം
reinforce	ശക്തിപ്പെടുത്തുക
reject	നിരസിക്കുക
relate	ബന്ധപ്പെടുക
relation	ബന്ധം
relationship	ബന്ധം
relative	ബന്ധു
relatively	താരതമ്യേന
relax	ശാന്തമാകൂ
release	പ്രകാശനം
relevant	പ്രസക്തമായ
relief	ആശ്വാസം
religion	മതം
religious	മതപരമായ
rely	ആശ്രയിക്കുക
remain	അവശേഷിക്കുന്നു
remaining	അവശേഷിക്കുന്നു
remarkable	ശ്രദ്ധേയമാണ്
remember	ഓർക്കുക
remind	ഓർമ്മിപ്പിക്കുന്നു
remote	വിദൂര
remove	നീക്കം ചെയ്യുക
repeat	ആവർത്തിച്ച്
repeatedly	ആവർത്തിച്ച്
replace	മാറ്റിസ്ഥാപിക്കുക
reply	മറുപടി
report	റിപ്പോർട്ട്
reporter	ലേഖകന്
represent	പ്രതിനിധീകരിക്കുന്നു
representation	പ്രാതിനിധ്യം
representative	പ്രതിനിധി
Republican	റിപ്പബ്ലിക്കൻ
reputation	മതിപ്പ്
request	അഭ്യർത്ഥന
require	ആവശ്യമാണ്
requirement	ആവശ്യം
research	ഗവേഷണം
researcher	ഗവേഷകൻ
resemble	സാദൃശ്യം
reservation	സംവരണം
resident	താമസക്കാരൻ
resist	പ്രതിരോധിക്കുക
resistance	പ്രതിരോധം
resolution	പ്രമേയം
resolve	പരിഹരിക്കുക
resort	റിസോർട്ട്
resource	വിഭവം
respect	ബഹുമാനം
respond	പ്രതികരിക്കുക
respondent	പ്രതിഭാഗം
response	പ്രതികരണം
responsibility	ഉത്തരവാദിത്തം
responsible	ഉത്തരവാദിയായ
rest	വിശ്രമം
restaurant	റെസ്റ്റോറന്റ്
restore	പുന .സ്ഥാപിക്കുക
restriction	നിയന്ത്രണവുമായി
result	ഫലമായി
retain	നിലനിർത്തുക
retire	വിരമിക്കുക
retirement	വിരമിക്കൽ
return	മടക്കം
reveal	വെളിപ്പെടുത്തുക
revenue	വരുമാനം
review	അവലോകനം
revolution	വിപ്ലവം
rhythm	താളം
rice	അരി
rich	സമ്പന്നൻ
rid	മോചിപ്പിക്കുക
ride	സവാരി
rifle	റൈഫിൾ
right	ശരിയാണ്
ring	വളയം
rise	ഉയരുക
risk	റിസ്ക്
river	നദി
road	റോഡ്
rock	പാറ
role	പങ്ക്
roll	ചുരുൾ
romantic	റൊമാന്റിക്
roof	മേൽക്കൂര
room	മുറി
root	റൂട്ട്
rope	കയർ
rose	റോസ്
rough	പരുക്കൻ
roughly	ഏകദേശം
round	ചുറ്റും
route	വഴി
routine	ദിനചര്യ
row	വരി
rub	തടവുക
rule	ഭരണം
run	ഓടുക
running	പ്രവർത്തിക്കുന്ന
rural	ഗ്രാമീണ
rush	തിരക്ക്
Russian	റഷ്യൻ
sacred	പവിത്രമായ
sad	ദുഃഖകരമായ
safe	സുരക്ഷിതം
safety	സുരക്ഷ
said	പറഞ്ഞു
sail	കപ്പൽ
sake	നിമിത്തം
salad	സാലഡ്
salary	ശമ്പളം
sale	വിൽപ്പന
sales	വിൽപന
salt	ഉപ്പ്
same	അതേ
sample	സാമ്പിൾ
sanction	അനുമതി
sand	മണല്
sat	ഇരുന്നു
satellite	ഉപഗ്രഹം
satisfaction	സംതൃപ്തി
satisfy	തൃപ്തിപ്പെടുത്തുക
sauce	സോസ്
save	രക്ഷിക്കും
saving	സംരക്ഷിക്കുന്നത്
saw	കണ്ടു
say	പറയുക
scale	സ്കെയിൽ
scandal	കോഴ
scared	പേടിച്ചു
scenario	രംഗം
scene	രംഗം
schedule	പട്ടിക
scheme	പദ്ധതി
scholar	പണ്ഡിതൻ
scholarship	സ്കോളർഷിപ്പ്
school	സ്കൂൾ
science	ശാസ്ത്രം
scientific	ശാസ്ത്രീയമായ
scientist	ശാസ്ത്രജ്ഞൻ
scope	ഭാവിയുളള
score	സ്കോർ
scream	നിലവിളിക്കുക
screen	സ്ക്രീൻ
script	തിരക്കഥ
sea	കടൽ
search	തിരയുക
season	സീസൺ
seat	ഇരിപ്പിടം
second	രണ്ടാമത്
secret	രഹസ്യം
secretary	സെക്രട്ടറി
section	വിഭാഗം
sector	മേഖല
secure	സുരക്ഷിത
security	സുരക്ഷ
see	കാണുക
seed	വിത്ത്
seek	അന്വേഷിക്കുക
seem	തോന്നുന്നു
segment	സെഗ്മെന്റ്
seize	പിടിച്ചെടുക്കുക
select	തിരഞ്ഞെടുക്കുക
selection	തിരഞ്ഞെടുപ്പ്
self	സ്വയം
sell	വിൽക്കുക
Senate	സെനറ്റ്
senator	സെനറ്റർ
send	അയയ്ക്കുക
senior	സീനിയർ
sense	അർത്ഥം
sensitive	സെൻസിറ്റീവ്
sent	അയച്ചു
sentence	വാചകം
separate	വെവ്വേറെ
sequence	ക്രമം
series	പരമ്പര
serious	ഗുരുതരമായ
seriously	ഗൗരവമായി
serve	സേവിക്കുക
service	സേവനം
session	സെഷൻ
set	സെറ്റ്
setting	ക്രമീകരണം
settle	തീർക്കുക
settlement	സെറ്റിൽമെന്റ്
seven	ഏഴ്
several	നിരവധി
severe	കഠിനമായ
sex	ലൈംഗികത
sexual	ലൈംഗിക
shade	തണല്
shadow	നിഴൽ
shake	കുലുക്കുക
shall	ചെയ്യും
shape	ആകൃതി
share	പങ്കിടുക
sharp	മൂർച്ചയുള്ള
she	അവൾ
sheet	ഷീറ്റ്
shelf	ഷെൽഫ്
shell	ഷെൽ
shelter	അഭയം
shift	ഷിഫ്റ്റ്
shine	തിളങ്ങുക
ship	കപ്പൽ
shirt	ഷർട്ട്
shit	ചാണകം
shock	ഞെട്ടൽ
shoe	ഷൂ
shoot	ഷൂട്ട്
shooting	ഷൂട്ടിംഗ്
shop	കട
shopping	ഷോപ്പിംഗ്
shore	തീരം
short	ചെറുത്
shortly	താമസിയാതെ
shot	വെടിയേറ്റു
should	വേണം
shoulder	തോൾ
shout	ആർപ്പുവിളിക്കുക
show	കാണിക്കുക
shower	ഷവർ
shrug	തോളിലേറ്റി
shut	അടയ്ക്കുക
sick	അസുഖം
side	വശം
sigh	നെടുവീർപ്പിടുക
sight	കാഴ്ച
sign	അടയാളം
signal	സിഗ്നൽ
significance	പ്രാധാന്യത്തെ
significant	പ്രധാനപ്പെട്ട
significantly	ഗണ്യമായി
silence	നിശ്ശബ്ദം
silent	നിശബ്ദമായി
silver	വെള്ളി
similar	സമാനമായ
similarly	സമാനമായി
simple	ലളിത
simply	ലളിതമായി
sin	പാപം
since	മുതലുള്ള
sing	പാടുക
singer	ഗായകൻ
single	സിംഗിൾ
sink	മുങ്ങുക
sir	സാർ
sister	സഹോദരി
sit	ഇരിക്കൂ
site	സൈറ്റ്
situation	സാഹചര്യം
six	ആറ്
size	വലിപ്പം
ski	സ്കീ
skill	വൈദഗ്ദ്ധ്യം
skin	തൊലി
sky	ആകാശം
slave	അടിമ
sleep	ഉറക്കം
slice	മുറിക്കുക
slide	സ്ലൈഡ്
slight	ചെറിയ
slightly	ചെറുതായി
slip	തെന്നുക
slow	പതുക്കെ
slowly	പതുക്കെ
small	ചെറിയ
smart	സ്മാർട്ട്
smell	മണം
smile	പുഞ്ചിരി
smoke	പുക
smooth	മിനുസമാർന്ന
snap	സ്നാപ്പ്
snow	മഞ്ഞ്
so	അങ്ങനെ
so-called	വിളിക്കപ്പെടുന്ന
soccer	സോക്കർ
social	സാമൂഹിക
society	സമൂഹം
soft	മൃദു
software	സോഫ്റ്റ്വെയർ
soil	മണ്ണ്
solar	സോളാർ
soldier	പട്ടാളക്കാരൻ
solid	ഖര
solution	പരിഹാരം
solve	പരിഹരിക്കുക
some	ചിലത്
somebody	ഏതോഒരാള്
somehow	എങ്ങനെയെങ്കിലും
someone	ആരെങ്കിലും
something	എന്തോ
sometimes	ചിലപ്പോൾ
somewhat	കുറച്ച്
somewhere	എവിടെയോ
son	മകൻ
song	പാട്ട്
soon	ഉടൻ
sophisticated	സങ്കീർണ്ണമായ
sorry	ക്ഷമിക്കണം
sort	അടുക്കുക
soul	ആത്മാവ്
sound	ശബ്ദം
soup	സൂപ്പ്
source	ഉറവിടം
south	തെക്ക്
southern	തെക്കൻ
Soviet	സോവിയറ്റ്
space	സ്ഥലം
Spanish	സ്പാനിഷ്
speak	സംസാരിക്കുക
speaker	സ്പീക്കർ
special	പ്രത്യേക
specialist	സ്പെഷ്യലിസ്റ്റ്
species	സ്പീഷീസ്
specific	നിർദ്ദിഷ്ട
specifically	പ്രത്യേകമായി
speech	പ്രസംഗം
speed	വേഗത
spell	അക്ഷരത്തെറ്റ്
spend	ചെലവഴിക്കുക
spending	ചെലവഴിക്കുന്നത്
spin	സ്പിൻ
spirit	ആത്മാവ്
spiritual	ആത്മീയം
split	രണ്ടായി പിരിയുക
spoke	സംസാരിച്ചു
spokesman	വക്താവ്
sport	കായിക
spot	പുള്ളി
spread	വ്യാപനം
spring	സ്പ്രിംഗ്
square	സമചതുരം Samachathuram
squeeze	ചൂഷണം ചെയ്യുക
stability	സ്ഥിരത
stable	സ്ഥിരതയുള്ള
staff	ജീവനക്കാർ
stage	സ്റ്റേജ്
stair	പടികൾ
stake	ഓഹരി
stand	നിൽക്കുക
standard	സ്റ്റാൻഡേർഡ്
standing	സ്റ്റാന്റിംഗ്
star	നക്ഷത്രം
stare	തുറിച്ചുനോക്കുക
start	ആരംഭിക്കുക
state	സംസ്ഥാനം
statement	പ്രസ്താവന
station	സ്റ്റേഷൻ
statistics	സ്ഥിതിവിവരക്കണക്കുകൾ
status	പദവി
stay	താമസിക്കുക
stead	പകരം
steady	സ്ഥിരതയുള്ള
steal	മോഷ്ടിക്കുക
steam	നീരാവി
steel	ഉരുക്ക്
step	ഘട്ടം
stick	വടി
still	നിശ്ചലമായ
stir	ഇളക്കുക
stock	സംഭരിക്കുക
stomach	വയറ്
stone	കല്ല്
stood	നിന്നു
stop	നിർത്തുക
storage	സംഭരണം
store	സ്റ്റോർ
storm	കൊടുങ്കാറ്റ്
story	കഥ
straight	ഋജുവായത്
strange	വിചിത്രം
stranger	അപരിചിതൻ
strategic	തന്ത്രപരമായ
strategy	തന്ത്രം
stream	ധാര
street	തെരുവ്
strength	ശക്തി
strengthen	ശക്തിപ്പെടുത്തുക
stress	സമ്മർദ്ദം
stretch	വലിച്ചുനീട്ടുക
strike	സമരം
string	സ്ട്രിംഗ്
strip	സ്ട്രിപ്പ്
stroke	സ്ട്രോക്ക്
strong	ശക്തമായ
strongly	ശക്തമായി
structure	ഘടന
struggle	സമരം
student	വിദ്യാർത്ഥി
studio	സ്റ്റുഡിയോ
study	പഠനം
stuff	സാധനങ്ങൾ
stupid	മണ്ടൻ
style	ശൈലി
subject	വിഷയം
submit	സമർപ്പിക്കുക
subsequent	തുടർന്നുള്ള
substance	വസ്തു
substantial	ഗണ്യമായ
subtract	കുറയ്ക്കുക
succeed	വിജയിക്കുക
success	വിജയം
successful	വിജയിച്ചു
successfully	വിജയകരമായി
such	അത്തരം
sudden	പെട്ടെന്ന്
suddenly	പെട്ടെന്ന്
sue	കേസെടുക്കുക
suffer	സഹിക്കുന്നു
sufficient	മതി
suffix	പ്രത്യയം
sugar	പഞ്ചസാര
suggest	നിർദ്ദേശിക്കുന്നു
suggestion	നിർദ്ദേശം
suicide	ആത്മഹത്യ
suit	സ്യൂട്ട്
summer	വേനൽ
summit	ഉച്ചകോടി
sun	സൂര്യൻ
super	സൂപ്പർ
supply	വിതരണം
support	പിന്തുണ
supporter	പിന്തുണയ്ക്കുന്നയാൾ
suppose	കരുതുക
supposed	കരുതപ്പെടുന്നു
Supreme	പരമോന്നത
sure	ഉറപ്പാണ്
surely	തീർച്ചയായും
surface	ഉപരിതലം
surgery	ശസ്ത്രക്രിയ
surprise	ആശ്ചര്യം
surprised	ആശ്ചര്യപ്പെട്ടു
surprising	അത്ഭുതപ്പെടുത്തുന്നു
surprisingly	അത്ഭുതകരമായി
surround	ചുറ്റും
survey	സർവേ
survival	അതിജീവനം
survive	അതിജീവിക്കുക
survivor	അതിജീവിച്ചയാൾ
suspect	സംശയിക്കുന്നു
sustain	നിലനിർത്തുക
swear	ആണയിടുക
sweep	തൂത്തുവാരുക
sweet	മധുരം
swim	നീന്തുക
swing	ഊഞ്ഞാലാടുക
switch	സ്വിച്ച്
syllable	അക്ഷരം
symbol	ചിഹ്നം
symptom	ലക്ഷണം
system	സിസ്റ്റം
table	മേശ
tablespoon	ടേബിൾസ്പൂൺ
tactic	തന്ത്രം
tail	വാൽ
take	എടുക്കുക
tale	കഥ
talent	പ്രതിഭ
talk	സംസാരിക്കുക
tall	ഉയരമുള്ള
tank	ടാങ്ക്
tap	ടാപ്പ്
tape	ടേപ്പ്
target	ലക്ഷ്യം
task	ചുമതല
taste	രുചി
tax	നികുതി
taxpayer	നികുതിദായകൻ
tea	ചായ
teach	പഠിപ്പിക്കുക
teacher	അധ്യാപകൻ
teaching	പഠിപ്പിക്കുന്നു
team	ടീം
tear	കണ്ണുനീർ
teaspoon	ടീസ്പൂൺ
technical	സാങ്കേതികമായ
technique	സാങ്കേതികത
technology	സാങ്കേതികവിദ്യ
teen	കൗമാരക്കാരൻ
teenager	കൗമാരക്കാരൻ
teeth	പല്ലുകൾ
telephone	ടെലിഫോണ്
telescope	ദൂരദർശിനി
television	ടെലിവിഷൻ
tell	പറയുക
temperature	താപനില
temporary	താൽക്കാലികം
ten	പത്ത്
tend	പ്രവണത
tendency	പ്രവണത
tennis	ടെന്നീസ്
tension	ടെൻഷൻ
tent	കൂടാരം
term	കാലാവധി
terms	നിബന്ധനകൾ
terrible	ഭയങ്കരം
territory	പ്രദേശം
terror	ഭീകരത
terrorism	തീവ്രവാദം
terrorist	തീവ്രവാദി
test	പരിശോധന
testify	സാക്ഷ്യപ്പെടുത്തുന്നു
testimony	സാക്ഷ്യം
testing	പരിശോധന
text	ടെക്സ്റ്റ്
than	അധികം
thank	നന്ദി
thanks	നന്ദി
that	അത്
the	എ
theater	തിയേറ്റർ
their	അവരുടെ
them	അവരെ
theme	തീം
themselves	സ്വയം
then	പിന്നെ
theory	സിദ്ധാന്തം
therapy	തെറാപ്പി
there	അവിടെ
therefore	അതുകൊണ്ടു
these	ഇവ
they	അവർ
thick	കട്ടിയുള്ള
thin	നേർത്ത
thing	കാര്യം
think	ചിന്തിക്കുക
thinking	ചിന്തിക്കുന്നതെന്ന്
third	മൂന്നാമത്
thirty	മുപ്പത്
this	ഈ
those	ആ
though	എങ്കിലും
thought	ചിന്തിച്ചു
thousand	ആയിരം
threat	ഭീഷണി
threaten	ഭീഷണിപ്പെടുത്തുന്നു
three	മൂന്ന്
throat	തൊണ്ട
through	വഴി
throughout	ഉടനീളം
throw	എറിയുക
thus	അങ്ങനെ
ticket	ടിക്കറ്റ്
tie	കെട്ടുക
tight	ഇറുകിയ
time	സമയം
tiny	ചെറിയ
tip	നുറുങ്ങ്
tire	ടയർ
tired	ക്ഷീണിച്ചു
tissue	ടിഷ്യു
title	ശീർഷകം
to	വരെ
tobacco	പുകയില
today	ഇന്ന്
toe	കാൽവിരൽ
together	ഒരുമിച്ച്
told	പറഞ്ഞു
tomato	തക്കാളി
tomorrow	നാളെ
tone	ടോൺ
tongue	നാവ്
tonight	ഇന്ന് രാത്രി
too	വളരെ
took	എടുത്തു
tool	ഉപകരണം
tooth	പല്ല്
top	മുകളിൽ
topic	വിഷയം
toss	ടോസ്
total	ആകെ
totally	പൂർണ്ണമായും
touch	സ്പർശിക്കുക
tough	കഠിനമായ
tour	പര്യടനം
tourist	ടൂറിസ്റ്റ്
tournament	ടൂർണമെന്റ്
toward	നേരെ
towards	നേരെ
tower	ഗോപുരം
town	പട്ടണം
toy	കളിപ്പാട്ടം
trace	ട്രെയ്സ്
track	ട്രാക്ക്
trade	വ്യാപാരം
tradition	പാരമ്പര്യം
traditional	പരമ്പരാഗത
traffic	ട്രാഫിക്
tragedy	ദുരന്തം
trail	പാത
train	ട്രെയിൻ
training	പരിശീലനം
transfer	കൈമാറ്റം
transform	രൂപാന്തരപ്പെടുത്തുക
transformation	രൂപാന്തരം
transition	പരിവർത്തനം
translate	വിവർത്തനം ചെയ്യുക
transportation	ഗതാഗതം
travel	യാത്ര
treat	ചികിത്സ
treatment	ചികിത്സ
treaty	ഉടമ്പടി
tree	വൃക്ഷം
tremendous	വമ്പിച്ച
trend	പ്രവണത
trial	വിചാരണ
triangle	ത്രികോണം
tribe	ഗോത്രം
trick	തന്ത്രം
trip	യാത്ര
troop	സൈന്യം
trouble	കുഴപ്പം
truck	ട്രക്ക്
truly	ശരിക്കും
trust	ആശ്രയം
truth	സത്യം
try	ശ്രമിക്കുക
tube	ട്യൂബ്
tunnel	തുരങ്കം
turn	വളവ്
TV	ടി.വി
twelve	പന്ത്രണ്ട്
twenty	ഇരുപത്
twice	രണ്ടുതവണ
twin	ഇരട്ട
two	രണ്ട്
type	തരം
typical	സാധാരണ
typically	താരതമ്യേനെ
ugly	വൃത്തികെട്ട
ultimate	ആത്യന്തികം
ultimately	ആത്യന്തികമായി
unable	കഴിയുന്നില്ല
uncle	അമ്മാവൻ
under	കീഴിൽ
undergo	വിധേയമാവുക
understand	മനസ്സിലാക്കുക
understanding	മനസ്സിലാക്കൽ
unfortunately	നിർഭാഗ്യവശാൽ
uniform	ഒരേപോലെ
union	യൂണിയൻ
unique	അതുല്യമായ
unit	യൂണിറ്റ്
United	യുണൈറ്റഡ്
universal	സാർവത്രിക
universe	പ്രപഞ്ചം
university	യൂണിവേഴ്സിറ്റി
unknown	അജ്ഞാതമാണ്
unless	അല്ലാതെ
unlike	വ്യത്യസ്തമായി
unlikely	സാധ്യതയില്ല
until	വരുവോളം
unusual	അസാധാരണമായ
up	മുകളിലേക്ക്
upon	മേൽ
upper	മുകളിലെ
urban	നഗര
urge	പ്രേരിപ്പിക്കുന്നു
us	ഞങ്ങളെ
use	ഉപയോഗിക്കുക
used	ഉപയോഗിച്ചു
useful	ഉപയോഗപ്രദമാണ്
user	ഉപയോക്താവ്
usual	സാധാരണ
usually	സാധാരണയായി
utility	യൂട്ടിലിറ്റി
vacation	അവധിക്കാലം
valley	താഴ്വര
valuable	വിലപ്പെട്ട
value	മൂല്യം
variable	വേരിയബിൾ
variation	വ്യതിയാനം
variety	വൈവിധ്യം
various	വിവിധ
vary	വ്യത്യാസപ്പെടുന്നു
vast	വിശാലമായ
vegetable	പച്ചക്കറി
vehicle	വാഹനം
venture	സംരംഭം
verb	ക്രിയ
version	പതിപ്പ്
versus	എതിരായി
very	വളരെ
vessel	പാത്രം
veteran	വിമുക്തഭടൻ
via	വഴി
victim	ഇര
victory	വിജയം
video	വീഡിയോ
view	കാഴ്ച
viewer	കാഴ്ചക്കാരൻ
village	ഗ്രാമം
violate	ലംഘിക്കുന്നു
violation	ലംഘനം
violence	അക്രമം
violent	അക്രമാസക്തമായ
virtually	ഫലത്തിൽ
virtue	സദാചാരം
virus	വൈറസ്
visible	ദൃശ്യം
vision	ദർശനം
visit	സന്ദർശിക്കുക
visitor	സന്ദർശകൻ
visual	ദൃശ്യം
vital	സുപ്രധാനം
voice	ശബ്ദം
volume	വ്യാപ്തം
volunteer	സദ്ധന്നസേവിക
vote	വോട്ടുചെയ്യുക
voter	വോട്ടർ
vowel	സ്വരാക്ഷരം
vs	വേഴ്സസ്
vulnerable	ദുർബല
wage	വേതന
wait	കാത്തിരിക്കുക
wake	ഉണരുക
walk	നടക്കുക
wall	മതിൽ
wander	അലഞ്ഞുതിരിയുന്നു
want	വേണം
war	യുദ്ധം
warm	ചൂടുള്ള
warn	മുന്നറിയിപ്പ്
warning	മുന്നറിയിപ്പ്
was	ആയിരുന്നു
wash	കഴുകുക
waste	മാലിന്യങ്ങൾ
watch	കാവൽ
water	വെള്ളം
wave	തരംഗം
way	വഴി
we	ഞങ്ങൾ
weak	ദുർബല
wealth	സമ്പത്ത്
wealthy	സമ്പന്നൻ
weapon	ആയുധം
wear	ധരിക്കുക
weather	കാലാവസ്ഥ
wedding	കല്യാണം
week	ആഴ്ച
weekend	വാരാന്ത്യം
weekly	പ്രതിവാര
weigh	തൂക്കുക
weight	ഭാരം
welcome	സ്വാഗതം
welfare	ക്ഷേമം
well	നന്നായി
went	പോയി
were	ആയിരുന്നു
west	പടിഞ്ഞാറ്
western	പടിഞ്ഞാറ്
wet	ആർദ്ര
what	എന്ത്
whatever	എന്തുതന്നെയായാലും
wheel	ചക്രം
when	എപ്പോൾ
whenever	എപ്പോൾ വേണമെങ്കിലും
where	എവിടെ
whereas	അതേസമയം
whether	എന്ന്
which	ഏത്
while	അതേസമയം
whisper	മന്ത്രിച്ചു
white	വെള്ള
who	ആര്
whole	മുഴുവൻ
whom	ആര്
whose	ആരുടെ
why	എന്തിന്
wide	വീതിയുള്ള
widely	പരക്കെ
widespread	വ്യാപകമായ
wife	ഭാര്യ
wild	കാട്ടു
will	ചെയ്യും
willing	തയ്യാറാണ്
win	വിജയിക്കുക
wind	കാറ്റ്
window	ജാലകം
wine	വൈൻ
wing	ചിറക്
winner	വിജയി
winter	ശീതകാലം
wipe	തുടയ്ക്കുക
wire	വയർ
wisdom	ജ്ഞാനം
wise	ബുദ്ധിമാനായ
wish	ആഗ്രഹം
with	കൂടെ
withdraw	പിൻവലിക്കുക
within	ഉള്ളിൽ
without	കൂടാതെ
witness	സാക്ഷി
woman	സ്ത്രീ
women	സ്ത്രീകള്
won’t	ചെയ്യില്ല
wonder	അത്ഭുതവും
wonderful	അത്ഭുതകരമായ
wood	മരം
wooden	തടി
word	വാക്ക്
work	ജോലി
worker	തൊഴിലാളി
working	ജോലി ചെയ്യുന്നു
works	പ്രവർത്തിക്കുന്നു
workshop	ശില്പശാല
world	ലോകം
worried	വിഷമിക്കുന്നു
worry	വിഷമിക്കുക
worth	മൂല്യം
would	ചെയ്യുമായിരുന്നു
wound	മുറിവ്
wrap	പൊതിയുക
write	എഴുതുക
writer	എഴുത്തുകാരൻ
writing	എഴുത്തു
written	എഴുതിയത്
wrong	തെറ്റാണ്
wrote	എഴുതി
yard	മുറ്റം
yeah	അതെ
year	വർഷം
yell	ആക്രോശിക്കുക
yellow	മഞ്ഞ
yes	അതെ
yesterday	ഇന്നലെ
yet	ഇതുവരെ
yield	വരുമാനം
you	നിങ്ങൾ
young	ചെറുപ്പക്കാരൻ
your	നിങ്ങളുടെ
yours	താങ്കളുടെ
yourself	സ്വയം
youth	യുവാക്കൾ
zombie	സോംബി
zone	മേഖല
zoo	മൃഗശാല
zoology	ജന്തുശാസ്ത്രം
zoom	സൂം
